GEHF	Leucocoprinus sp. HH-2015f
GEHG	Leucocoprinus sp. HH-2015c
GEHH	Leucocoprinus sp. HH-2015a
GEHI	Leucocoprinus sp. HH-2015b
GEHJ	Ictalurus punctatus
GEHL	Phalotris mertensi
GEHM	Parvilacerta parva
GEHN	Apios americana
GEHO	Lamellibrachia satsuma
GEHP	Porites astreoides
GEHQ	Dinarolacerta mosorensis
GEHR	Phoenicolacerta troodica
GEHS	Podarcis cretensis
GEHT	Catonia nava
GEHU	Tettigarcta crinita
GEHV	Hyalella azteca
GEHW	Darevskia unisexualis
GEHX	Zootoca vivipara
GEHY	Triops newberryi
GEHZ	Lepidosiren paradoxa
GEIA	Hevea brasiliensis
GEIB	Carios mimon
GEIC	Betula papyrifera
GEID	Callinectes sapidus
GEIE	Sepia pharaonis
GEIF	Periplaneta americana
GEIG	Girardia dorotocephala
GEIH	Anasa tristis
GEII	Anasa tristis
GEIJ	Thionia simplex
GEIK	Tamasa doddi
GEIL	Tinobregmus viridescens
GEIM	Tettigades auropilosa
GEIN	Stenocotis depressa
GEIO	Scolypopa sp. KJ-2015
GEIP	Ozophora sp. KJ-2015
GEIQ	Platybrachys sp. KJ-2015
GEIR	Brachyplatys sp. KJ-2015
GEIT	Phaenacantha australiae
GEIU	Pachygrontha sp. KJ-2015
GEIW	Omolicna uhleri
GEIX	Microcentrus caryae
GEIY	Lipocallia australensis
GEIZ	Umbonia crassicornis
GEJB	Maoricicada tenuis
GEJC	Neocoelidia tumidifrons
GEJE	Macropsis decisa
GEJF	Kikihia scutellaris
GEJG	Idiocerus rotundens
GEJH	Jamella australiae
GEJK	Guineapsaltria flava
GEJL	Euacanthella palustris
GEJQ	Heteronotus sp. KJ-2015
GEJR	Lygaeidae sp. KJ-2015
GEJT	Clastoptera obtusa
GEJW	Epipyga sp. KJ-2015
GEJZ	Burbunga queenslandica
GEKH	Chilecicada sp. KJ-2015
GEKK	Phagocata morgani
GEKL	Perna viridis
GEKN	Nionia palmeri
GEKO	Pectinariophyes stalii
GEKT	Salvelinus alpinus
GEKU	Channa punctata
GEKW	Anemone flaccida
GEKX	Phragmites australis
GEKY	Channa punctata
GEKZ	Channa punctata
GELA	Ictalurus punctatus
GELB	Sparassis latifolia
GELC	Xestocephalus desertorum
GELE	Crepidula navicella
GELF	Bromus tectorum
GELG	Diachasmimorpha longicaudata
GELH	Pinctada fucata
GELI	Aegiceras corniculatum
GELJ	Rhipicephalus microplus
GELK	Noctiluca scintillans
GELL	Megalopta genalis
GELM	Corynactis australis
GELN	Ricordea yuma
GELO	Rhodactis indosinensis
GELP	Gocevia fonbrunei
GELQ	Unda schaefferi
GELR	Clydonella sp. ATCC 50884
GELS	Thecamoeba quadrilineata
GELT	Parvamoeba monoura
GELU	Vermistella antarctica
GELV	Micropterna lateralis
GELW	Taxillus chinensis
GELX	Brachionus plicatilis
GELY	Saccharum officinarum
GELZ	Nematolebias whitei
GEMA	Channa punctata
GEMB	Triatoma infestans
GEMC	Nasturtium officinale
GEMD	Posidonia oceanica
GEME	Penaeus monodon
GEMF	Takydromus sexlineatus
GEMG	Raphanus sativus
GEMH	Narenga porphyrocoma
GEMI	Pedicia vetusta
GEMJ	Rhipidia sejuga
GEMK	Liogma simplicicornis
GEML	Channa argus
GEMM	Cymodocea nodosa
GEMN	Pinus sylvestris
GEMO	Pteria penguin
GEMP	Hematodinium sp. SG-2012
GEMQ	Tityus obscurus
GEMR	Rhipicephalus microplus
GEMS	Rhopilema esculentum
GEMT	Dendrocalamus latiflorus
GEMU	Selaginella bryopteris
GEMV	Nicotiana obtusifolia
GEMW	Epipremnum aureum
GEMX	Mesocricetus auratus
GEMY	Alternaria sp. MG1
GEMZ	Entomophthora muscae
GENA	Entomophthora muscae
GENB	Entomophthora muscae
GENC	Entomophthora muscae
GEND	Entomophthora muscae
GENE	Dryophytes cinereus
GENF	Kryptolebias marmoratus
GENG	Phyllostachys edulis
GENH	Dryadaula visaliella
GENI	Palaephatus luteolus
GENJ	Phymatopus californicus
GENK	Mythimna separata
GENL	Gallus gallus gallus
GENM	Thyridopteryx ephemeraeformis
GENN	Tineola bisselliella
GENO	Tischeria quercitella
GENP	Acanthopteroctetes unifascia
GENQ	Ophryotrocha diadema
GENR	Eudarcia simulatricella
GENS	Ptyssoptera sp. AB-2015
GENT	Acanthopteroctetes unifascia
GENU	Acanthopteroctetes unifascia
GENV	Mucuna pruriens
GENW	Phalaenopsis aphrodite subsp. formosana
GENX	Agathiphaga queenslandensis
GENY	Agathiphaga queenslandensis
GENZ	Agathiphaga queenslandensis
GEOA	Andesiana lamellata
GEOB	Azaleodes micronipha
GEOC	Dyseriocrania griseocapitella
GEOD	Dryadaula visaliella
GEOE	Enteucha acetosae
GEOF	Eudarcia simulatricella
GEOG	Heterobathmia pseuderiocrania
GEOH	Ambrosia trifida
GEOI	Cylas formicarius
GEOJ	Lophocorona astiptica
GEOK	Metaphatus ochraceus
GEOL	Metaphatus ochraceus
GEOM	Metaphatus ochraceus
GEON	Palaephatus luteolus
GEOO	Phymatopus californicus
GEOP	Palaephatus nielseni
GEOQ	Thyridopteryx ephemeraeformis
GEOR	Tineola bisselliella
GEOS	Neopseustis meyricki
GEOT	Pseudopostega quadristrigella
GEOU	Tischeria quercitella
GEOV	Tegeticula yuccasella
GEOW	Photinus pyralis
GEOX	Euprymna scolopes
GEOY	Allium cepa
GEOZ	Pongamia pinnata
GEPA	Oxyacanthus curtus
GEPB	Oxyacanthus flavus
GEPC	Oxyacanthus sowinskii
GEPD	Brachyuropus grewingkii
GEPE	Acanthogammarus godlewskii
GEPF	Cornugammarus maximus
GEPG	Boeckaxelia carpenterii
GEPH	Boeckaxelia potanini
GEPI	Baikalogammarus pullus
GEPJ	Brandtia latissima
GEPK	Asprogammarus rhodophthalmus
GEPL	Carinurus bicarinatus
GEPM	Crypturopus inflatus
GEPN	Echiuropus macronychus
GEPO	Eucarinogammarus wagii
GEPP	Sluginella kietlinskii
GEPQ	Eulimnogammarus similis
GEPR	Heterogammarus sophianosii
GEPS	Eulimnogammarus cyaneus
GEPT	Eulimnogammarus marituji
GEPU	Eulimnogammarus viridulus
GEPV	Eulimnogammarus vittatus
GEPW	Eulimnogammarus cruentus
GEPX	Eulimnogammarus cruentus
GEPY	Eulimnogammarus czerskii
GEPZ	Eulimnogammarus messerschmidtii
GEQA	Eulimnogammarus sp. gam2quest
GEQB	Eulimnogammarus sp. gam16.4
GEQC	Eulimnogammarus verrucosus
GEQD	Garjajewia dershawini
GEQE	Gmelinoides fasciatus
GEQF	Hyalellopsis carinata
GEQG	Hyalellopsis costata
GEQH	Hyalellopsis grisea
GEQI	Hyalellopsis setosa
GEQJ	Hyalellopsis stebbingi
GEQK	Macrohectopus branickii
GEQL	Macropereiopus wagneri
GEQM	Macropereiopus parvus
GEQN	Micruropus glaber
GEQO	Micruropus parvulus
GEQP	Micruropus wahlii
GEQQ	Odontogammarus calcaratus
GEQR	Ommatogammarus albinus
GEQS	Ommatogammarus flavus
GEQT	Pachyschesis branchialis
GEQU	Pachyschesis branchialis
GEQV	Pentagonurus dawydowi
GEQW	Palicarinus puzyllii
GEQX	Pallasea cancelloides
GEQY	Pallaseopsis kessleri
GEQZ	Pallasea sp. gam7.3
GERA	Pandorites podoceroides
GERB	Parapallasea wosnessenskii
GERC	Eulimnogammarus testaceus
GERD	Gammarus lacustris
GERE	Homalogammarus brandtii
GERF	Pallasea cancelloides
GERG	Ptyssoptera sp. AB-2015
GERH	Linevichella vortex
GERI	Pallasea cancellus
GERJ	Pallasea grubei
GERK	Parapallasea borowskii
GERL	Poekilogammarus pictoides
GERM	Dorogostaiskia parasitica
GERO	Acopauropus ornatus
GERP	Araneus diadematus
GERQ	Callipus foetidissimus
GERS	Craspedosoma sp. AD-2016
GERT	Cryptops anomalans
GERU	Damon diadema
GERV	Egaenus convexus
GERW	Eupolybothrus fasciatus
GERX	Eupolybothrus tridentinus
GERY	Glomeridella minima
GERZ	Hanseniella nivea
GESA	Haploglomeris multistriata
GESB	Henia illyrica
GESH	Peripatoides novaezealandiae
GESI	Polydesmus complanatus
GESK	Strigamia acuminata
GESL	Schendyla carniolensis
GESM	Polyxenus lagurus
GESN	Polyzonium germanicum
GESO	Palythoa caribaeorum
GESP	Spodoptera frugiperda
GESQ	Eulimnogammarus ussolzewii
GESR	Eulimnogammarus violaceus
GESS	Tylototriton wenxianensis
GEST	Trifolium repens
GESU	Pinus canariensis
GESV	Clione limacina
GESW	Cymbidium longibracteatum
GESX	Swertia japonica
GESY	Asymmetron lucayanum
GESZ	Branchiostoma floridae
GETA	Branchiostoma floridae
GETB	Acanthogorgia aspera
GETC	Asymmetron lucayanum
GETD	Penaeus vannamei
GETE	Ornithodoros brasiliensis
GETF	Allium cepa
GETG	Larimichthys polyactis
GETH	Cyphastrea serailia
GETI	Manduca sexta
GETJ	Rosa chinensis
GETK	Gambierdiscus polynesiensis
GETL	Gambierdiscus excentricus
GETM	Varroa jacobsoni
GETN	Scirpophaga incertulas
GETO	Varroa jacobsoni
GETP	Varroa jacobsoni
GETQ	Rhagoletis pomonella
GETR	Pterygoplichthys anisitsi
GETS	Locusta migratoria manilensis
GETT	Meganyctiphanes norvegica
GETV	Xenodon merremii
GETW	Euphorbia tirucalli
GETX	Acipenser sinensis
GETY	Alosa alosa
GETZ	Penaeus vannamei
GEUA	Penaeus aztecus
GEUB	Lateolabrax japonicus
GEUC	Agrostis stolonifera
GEUD	Callosobruchus maculatus
GEUE	Callosobruchus maculatus
GEUF	Callosobruchus maculatus
GEUG	Amia calva
GEUH	Callosobruchus maculatus
GEUI	Cyclocarya paliurus
GEUJ	Alatina alata
GEUK	Opuntia ficus-indica
GEUL	Acipenser oxyrinchus
GEUN	Aureoumbra lagunensis
GEUO	Podosphaera xanthii
GEUP	Zenia insignis
GEUQ	Ctenopharyngodon idella
GEUR	Quercus kerrii
GEUS	Quercus austrocochinchinensis
GEUT	Scylla paramamosain
GEUU	Pisum sativum
GEUV	Manis javanica
GEUW	Tityus serrulatus
GEUX	Triticum aestivum
GEUY	Cenchrus americanus
GEUZ	Pinus lambertiana
GEVA	Phodopus campbelli
GEVB	Phodopus sungorus
GEVC	Trichomycterus areolatus
GEVD	Meccus pallidipennis
GEVE	Actinia tenebrosa
GEVF	Trachinotus blochii
GEVG	Basilichthys microlepidotus
GEVH	Salaria pavo
GEVI	Noccaea caerulescens
GEVJ	Cochliomyia hominivorax
GEVK	Noccaea caerulescens
GEVL	Noccaea caerulescens
GEVM	Noccaea caerulescens
GEVN	Veronica panormitana
GEVO	Veronica cymbalaria
GEVP	Veronica cymbalaria
GEVQ	Veronica hectorii subsp. coarctata
GEVR	Veronica ochracea
GEVS	Veronica planopetiolata
GEVT	Veronica catarractae
GEVU	Veronica trichadena
GEVV	[Candida] africana
GEVW	Candida albicans
GEVX	Fasciola hepatica
GEVY	Menidia menidia
GEVZ	Hydra vulgaris
GEWA	Paramoeba pemaquidensis
GEWB	Costaria costata
GEWC	Ecklonia radiata
GEWD	Saccharina latissima
GEWE	Laminaria digitata
GEWF	Lessonia nigrescens
GEWG	Chorda filum
GEWH	Nereocystis luetkeana
GEWI	Cymathaere triplicata
GEWJ	Egregia menziesii
GEWK	Pterygophora californica
GEWL	Pleurophycus gardneri
GEWM	Lessonia variegata
GEWN	Alaria esculenta
GEWO	Agarum clathratum
GEWP	Laminaria digitata
GEWQ	Ecklonia arborea
GEWR	Ilex paraguariensis
GEWS	Helianthus niveus
GEWT	Juniperus ashei
GEWU	Triticum aestivum
GEWV	Juniperus virginiana
GEWW	Juniperus monosperma
GEWX	Juniperus pinchotii
GEWY	Reticulitermes flavipes
GEWZ	Nephilengys cruentata
GEXA	Bothrops jararaca
GEXB	Rhodotorula toruloides
GEXC	Acanthogorgia aspera
GEXD	Nepenthes khasiana
GEXE	Euprymna tasmanica
GEXF	Sepioloidea lineolata
GEXG	Octopus kaurna
GEXH	Hapalochlaena maculosa
GEXI	Anadara broughtonii
GEXJ	Phragmites australis
GEXK	Lutjanus erythropterus
GEXL	Macrostomum lignano
GEXM	Oxysternon conspicillatum
GEXN	Malaclemys terrapin terrapin
GEXO	Malaclemys terrapin terrapin
GEXP	Coffea arabica
GEXQ	Malaclemys terrapin terrapin
GEXR	Malaclemys terrapin terrapin
GEXS	Malaclemys terrapin terrapin
GEXT	Malaclemys terrapin terrapin
GEXU	Malaclemys terrapin terrapin
GEXV	Malaclemys terrapin terrapin
GEXW	Malaclemys terrapin terrapin
GEXX	Achipteria coleoptrata
GEXY	Megaloprepus caerulatus
GEXZ	Malaclemys terrapin terrapin
GEYA	Salix integra
GEYB	Hermannia gibba
GEYC	Corydoras nattereri
GEYD	Corydoras nattereri
GEYE	Corydoras nattereri
GEYF	Hoplosternum littorale
GEYG	Hoplosternum littorale
GEYH	Cucurbita pepo
GEYI	Actinidia deliciosa
GEYJ	Nothrus palustris
GEYK	Corydoras nattereri
GEYL	Hoplosternum littorale
GEYM	Corydoras schwartzi
GEYN	Plutella xylostella
GEYO	Haliotis midae
GEYP	Hypochthonius rufulus
GEYQ	Steganacarus magnus
GEYR	Haliotis midae
GEYS	Bactrocera dorsalis
GEYT	Silene ammophila
GEYU	Silene conoidea
GEYV	Silene grisebachii
GEYW	Silene subconica
GEYX	Silene undulata
GEYY	Duabanga grandiflora
GEYZ	Platynothrus peltifer
GEZA	Silene sartorii
GEZB	Locusta migratoria
GEZC	Pisum sativum
GEZD	Globodera ellingtonae
GEZE	Trapa bispinosa
GEZF	Sonneratia caseolaris
GEZG	Citrus sp. JT-2016
GEZH	Leucoraja ocellata
GEZI	Cordyceps militaris
GEZJ	Agarophyton chilense
GEZK	Bemisia tabaci
GEZL	Ambrosia artemisiifolia
GEZM	Photinus pyralis
GEZN	Paulinella chromatophora
GEZO	Spodoptera litura
GEZP	Schistosoma japonicum
GEZQ	Cosmos bipinnatus
GEZR	Boletopsis grisea
GEZS	insect gut metagenome
GEZT	Solanum prinophyllum
GEZU	Amoeba sp. BB2
GEZV	Dendrobium catenatum
GEZW	endophyte metagenome
GEZX	Hirondellea gigas
GEZY	Sitophilus oryzae
GEZZ	Diadromus collaris
GFAA	Amblyomma sculptum
GFAB	Spodoptera frugiperda
GFAC	Amblyomma aureolatum
GFAD	Nepenthes ventricosa x Nepenthes alata
GFAE	Nepenthes ampullaria
GFAF	Cotesia vestalis
GFAG	Eurhomalea rufa
GFAH	Hadrurus spadix
GFAI	Octopus maya
GFAJ	Allium ascalonicum
GFAK	Allium cepa var. aggregatum
GFAL	Allium chinense
GFAM	Allium fistulosum
GFAN	Allium tuberosum
GFAO	Allium macrostemon
GFAP	Allium sativum
GFAQ	Fukomys darlingi
GFAR	Allium ampeloprasum
GFAS	Millepora alcicornis
GFAT	Mnemiopsis leidyi
GFAU	Oryza sativa Indica Group
GFAV	Haliclona tubifera
GFAW	Absidia caerulea
GFAX	Carausius morosus
GFAY	Citrus limon
GFAZ	Galaxea fascicularis
GFBA	Tupiocoris notatus
GFBB	Lomandra longifolia
GFBC	Mucor irregularis
GFBD	Camponotus fellah
GFBE	Ansanella granifera
GFBF	Ulmus pumila
GFBG	Megacormus gertschi
GFBH	Eogystia hippophaecolus
GFBI	Tegula atra
GFBJ	Amblyomma americanum
GFBK	Eriocheir sinensis
GFBL	Eriocheir sinensis
GFBM	Ambystoma mexicanum
GFBN	Paulownia elongata
GFBO	Pinus albicaulis
GFBP	Juncus effusus
GFBQ	Dreissena polymorpha
GFBR	Lens culinaris
GFBS	Lithobates catesbeianus
GFBT	Nymphoides peltata
GFBU	Rafflesia cantleyi
GFBV	Tetronarce californica
GFBW	Hemideina thoracica
GFBX	Hemideina crassidens
GFBY	Crotalaria juncea
GFBZ	Picea glauca
GFCA	Penaeus monodon
GFCB	Nicotiana tabacum
GFCC	Salpa thompsoni
GFCD	Superstitionia donensis
GFCE	Iotanema spirale
GFCF	Trypanoplasma borreli
GFCG	Silene dioica
GFCH	Silene dioica
GFCI	Pleuromamma xiphias
GFCJ	Loxostege sticticalis
GFCK	Alosa pseudoharengus
GFCL	Anguilla japonica
GFCM	Anguilla japonica
GFCN	Sminthopsis crassicaudata
GFCO	Murraya koenigii
GFCP	Ampulex compressa
GFCQ	Periplaneta americana
GFCS	Euphausia superba
GFCT	Mythimna separata
GFCU	Rhododendron delavayi
GFCV	Gammarus chevreuxi
GFCW	Peromyscus californicus
GFCX	Antheraea pernyi
GFCY	Bombyx mori
GFCZ	Latrodectus geometricus
GFDA	Homarus americanus
GFDB	Latrodectus hesperus
GFDC	Steatoda grossa
GFDD	Elaeis guineensis
GFDE	Hypericum perforatum
GFDF	Nyssomyia neivai
GFDG	Haematobia irritans
GFDH	soil metagenome
GFDI	Chamaecyparis hodginsii
GFDJ	Corchorus olitorius
GFDK	Ananas comosus
GFDL	Culex tarsalis
GFDM	Paragymnodinium shiwhaense
GFDN	Phytophthora palmivora
GFDO	Corchorus olitorius
GFDP	Labrus bergylta
GFDQ	Sturnus vulgaris
GFDR	Symbiodinium muscatinei
GFDT	Elliptochloris marina
GFDU	Lateolabrax maculatus
GFDV	Nepenthes khasiana
GFDW	Aetalion reticulatum
GFDX	Agudus sp. AgspCi3
GFDY	Amastris sp. AmspME1B
GFDZ	Aphrodes bicincta
GFEA	Bladina sp. BlspNO2
GFEB	Chelyoidea sp. ChspME22
GFEC	Cyphonia clavata
GFEF	Yucanda albida
GFEH	Hackeriella veitchi
GFEI	Tituria crinita
GFEJ	Tettigometra bipunctata
GFEO	Tolania sp. TospME4
GFEQ	Lophyraspis sp. LospAE
GFER	Lycoderes burmeisteri
GFES	Lycorma delicatula
GFET	Membracis tectigera
GFEY	Ricania speculum
GFFB	Notocera sp. NospME1B
GFFC	Penestragania robusta
GFFD	Procyrta sp. PrspME4
GFFF	Penthimia sp. PespCi34
GFFH	Oratosquilla oratoria
GFFI	Triticum aestivum
GFFJ	Portunus trituberculatus
GFFK	Microphallus sp. 'livelyi'
GFFL	Microphallus sp. 2 LB-2017
GFFM	Labrus bergylta
GFFN	Phlox cuspidata
GFFO	Phlox pilosa
GFFP	Phlox drummondii
GFFQ	Phlox roemeriana
GFFR	Phlox drummondii
GFFU	Triticum turgidum subsp. durum
GFFV	Castor canadensis
GFFW	Castor canadensis
GFFX	Juniperus excelsa
GFFY	Pseudotsuga menziesii
GFFZ	Machimus arthriticus
GFGA	Eutolmus rufibarbis
GFGB	Dasypogon diadema
GFGC	Capra hircus
GFGD	Capra hircus
GFGE	Capra hircus
GFGF	Capra hircus
GFGG	Capra hircus
GFGH	Capra hircus
GFGI	Hyalomma dromedarii
GFGJ	Marchantia paleacea
GFGK	Brachionus manjavacas
GFGL	Tectona grandis
GFGM	Osteoglossum bicirrhosum
GFGN	Avena fatua
GFGO	Capra hircus
GFGP	Capra hircus
GFGQ	Capra hircus
GFGR	Capra hircus
GFGS	Oryza sativa Indica Group
GFGT	Millepora complanata
GFGU	Millepora squarrosa
GFGV	Millepora sp. RR-2016
GFGW	Hypsibius dujardini
GFGX	Coregonus clupeaformis
GFGY	Paramacrobiotus richtersi
GFGZ	Milnesium tardigradum
GFHA	Melanotaenia splendida tatei
GFHB	Pinus massoniana
GFHC	Cyathus bulleri
GFHD	Margaritifera margaritifera
GFHE	Gyrodiniellum shiwhaense
GFHF	Poecilia reticulata
GFHG	Poecilia reticulata
GFHH	Poecilia reticulata
GFHI	Poecilia reticulata
GFHJ	Saccharum hybrid cultivar
GFHK	Syzygium luehmannii
GFHL	Syzygium luehmannii
GFHM	Syzygium luehmannii
GFHN	Syzygium luehmannii
GFHO	Syzygium luehmannii
GFHP	Yucca gloriosa
GFHQ	Cordyline australis
GFHR	Penicillium raistrickii
GFHS	Syzygium luehmannii
GFHT	Syzygium luehmannii
GFHU	Avena sativa
GFHV	Ilex paraguariensis
GFHW	Crotalus adamanteus
GFHX	Dactylorhiza fuchsii
GFHY	Cornu aspersum
GFHZ	Saccharum hybrid cultivar
GFIA	Juniperus excelsa
GFIB	Mytilus californianus
GFIC	Anguilla anguilla
GFID	Apteronotus albifrons
GFIE	Astyanax mexicanus
GFIF	Astyanax mexicanus
GFIG	Coregonus lavaretus
GFIH	Mytilus californianus
GFII	Mytilus californianus
GFIJ	Gossypium hirsutum
GFIK	Gnathonemus petersii
GFIL	Danio rerio
GFIM	Lepisosteus oculatus
GFIN	Oncorhynchus mykiss
GFIO	Oryzias latipes
GFIP	Pantodon buchholzi
GFIQ	Perca fluviatilis
GFIR	Plecoglossus altivelis
GFIS	Salmo trutta
GFIT	Salvelinus fontinalis
GFIU	Umbra pygmaea
GFIV	Crypthecodinium cohnii
GFIW	Agrostis scabra
GFIX	Gadus morhua
GFIY	Piper nigrum
GFIZ	Thymallus thymallus
GFJA	Brachypodium distachyon
GFJB	Brachypodium distachyon
GFJC	Brachypodium distachyon
GFJD	Aldrovandia affinis
GFJE	Taraxacum kok-saghyz
GFJG	Eurypanopeus depressus
GFJH	Agrostis stolonifera
GFJI	Echinochloa colona
GFJJ	Hordeum vulgare subsp. vulgare
GFJK	Hordeum vulgare subsp. vulgare
GFJL	Hordeum vulgare subsp. vulgare
GFJM	Bothrops jararaca
GFJN	Hordeum vulgare subsp. vulgare
GFJO	Hordeum vulgare subsp. vulgare
GFJP	Sporobolus stapfianus
GFJQ	Ornithodoros moubata
GFJR	Saccharomyces cerevisiae
GFJS	Saccharomyces cerevisiae
GFJT	Posidonia oceanica
GFJU	Tomicus yunnanensis
GFJV	Dactylorhiza incarnata
GFJW	Dicentrarchus labrax
GFJX	Dicentrarchus labrax
GFJY	Dugesia japonica
GFJZ	Macrostomum tuba
GFKA	Schmidtea polychroa
GFKB	Bdelloura candida
GFKC	Ishige okamurae
GFKD	Punctaria latifolia
GFKE	Sargassum henslowianum
GFKF	Desmarestia viridis
GFKG	Sargassum vachellianum
GFKH	Scytosiphon lomentaria
GFKI	Sargassum muticum
GFKJ	Sargassum fusiforme
GFKK	Dictyopteris undulata
GFKL	Colpomenia sinuosa
GFKM	Sargassum horneri
GFKN	Scytosiphon dotyi
GFKO	Petalonia fascia
GFKP	Betaphycus philippinensis
GFKQ	Dumontia simplex
GFKR	Grateloupia livida
GFKS	Mytilisepta virgata
GFKT	Trichonephila clavipes
GFKU	Apostichopus japonicus
GFKV	Phagocata velata
GFKW	Trigonella foenum-graecum
GFKX	Sargassum hemiphyllum var. chinense
GFKY	Pyropia yezoensis
GFKZ	Eucheuma denticulatum
GFLA	Grateloupia turuturu
GFLB	Mazzaella japonica
GFLC	Grateloupia catenata
GFLD	Ambystoma 'unisexual hybrid'
GFLE	Sargassum integerrimum
GFLF	Kappaphycus alvarezii
GFLG	Grateloupia filicina
GFLH	Heterosiphonia pulchra
GFLI	Ambystoma tigrinum
GFLJ	Ambystoma texanum
GFLK	Apostichopus japonicus
GFLL	Pinus albicaulis
GFLM	Karenia brevis
GFLN	Sus scrofa
GFLO	Ambystoma laterale
GFLP	Saccharum hybrid cultivar
GFLQ	Trigonella foenum-graecum
GFLR	Trigonella foenum-graecum
GFLS	Trigonella foenum-graecum
GFLT	Sepiella maindroni
GFLU	Cepaea nemoralis
GFLV	Formica exsecta
GFLW	Aphidius ervi
GFLX	Euterpe oleracea
GFLY	Avicennia officinalis
GFLZ	Potamopyrgus antipodarum
GFMA	fermentation metagenome
GFMB	Chionochloa macra
GFMC	Triatoma infestans
GFMD	Litchi chinensis
GFME	Megaphragma amalphitanum
GFMF	Syzygium luehmannii
GFMG	Gryllus bimaculatus
GFMH	Tenualosa ilisha
GFMI	Paspalum notatum
GFMJ	Triatoma dimidiata
GFMK	Meccus pallidipennis
GFML	Tarenaya hassleriana
GFMM	Maccullochella peelii
GFMN	Chionodraco hamatus
GFMO	Pieris rapae
GFMP	Vibrio alginolyticus
GFMQ	Gynandropsis gynandra
GFMR	Nibea albiflora
GFMS	Oryza sativa
GFMT	Rhinella marina
GFMU	Camellia sinensis
GFMV	Camellia sinensis
GFMW	Biomphalaria pfeifferi
GFMX	Chlorococcum amblystomatis
GFMY	Ambystoma maculatum
GFMZ	Chlorococcum amblystomatis
GFNA	Aedes aegypti
GFNB	Pseudomonas stutzeri
GFNC	Trigonella foenum-graecum
GFND	Trigonella foenum-graecum
GFNE	Xipholeptos notoides
GFNF	Cricotopus parbicinctus
GFNG	Cricotopus albitarsis
GFNH	Trigonella foenum-graecum
GFNI	Cricotopus draysoni
GFNJ	Oreobates cruralis
GFNK	Conus gloriamaris
GFNL	Nodipecten subnodosus
GFNM	Limacina helicina
GFNN	Premolis semirufa
GFNO	Lasius niger
GFNP	Helicoverpa armigera
GFNR	Paspalum notatum
GFNS	Plantago ovata
GFNT	Bactrocera kraussi
GFNU	Falco sparverius
GFNV	Leucophaeus atricilla
GFNW	Pandion haliaetus
GFNX	Bactrocera frauenfeldi
GFNY	Bactrocera jarvisi
GFNZ	Bactrocera musae
GFOA	Bactrocera bryoniae
GFOB	Aloe vera
GFOD	Caecilia tentaculata
GFOE	Microcaecilia dermatophaga
GFOF	Microcaecilia unicolor
GFOG	Rhinatrema bivittatum
GFOH	Typhlonectes compressicauda
GFOI	Candidatus Thiodiazotropha endoloripes
GFOJ	Candidatus Thiodiazotropha endolucinida
GFOK	Actinidia eriantha
GFOL	Neoporphyra haitanensis
GFOM	Neoporphyra haitanensis
GFON	Coilia nasus
GFOO	Nodipecten subnodosus
GFOP	Lepidotrigona ventralis
GFOQ	Patiria pectinifera
GFOR	Bactrocera latifrons
GFOS	Rhagovelia antilleana
GFOT	Lilium
GFOU	Zeugodacus cucumis
GFOV	Lepomis macrochirus
GFOW	Prosopis cineraria
GFOX	Pyrrhocoris apterus
GFOY	Paris polyphylla var. yunnanensis
GFOZ	Nasonia giraulti
GFPA	Urolepis rufipes
GFPB	Trichomalopsis sarcophagae
GFPC	Nasonia vitripennis
GFPD	Schmidtea mediterranea
GFPE	Holacanthella duospinosa
GFPF	Rhipicephalus zambeziensis
GFPG	Palaemon varians
GFPH	Lepomis microlophus
GFPI	Epilachna varivestis
GFPJ	Paris polyphylla var. yunnanensis
GFPK	Chiloglottis trapeziformis
GFPL	Pygospio elegans
GFPM	Symbiodinium sp. A4
GFPN	Schmidtea mediterranea
GFPO	Charybdis japonica
GFPP	Timema bartmani
GFPQ	Colletotrichum sansevieriae
GFPR	Timema genevievae
GFPS	Timema californicum
GFPT	Timema cristinae
GFPU	Timema douglasi
GFPV	Timema monikensis
GFPW	Timema podura
GFPX	Timema poppensis
GFPY	Timema shepardi
GFPZ	Timema tahoe
GFQA	ciliate metagenome
GFQB	Camellia sinensis
GFQC	Camellia sinensis
GFQD	Camellia sinensis
GFQE	Acropora gemmifera
GFQG	Amaranthus palmeri
GFQH	Prunus armeniaca
GFQI	Schmidtea mediterranea
GFQJ	Deinococcus radiodurans
GFQK	Agrostis stolonifera
GFQL	Carposina sasakii
GFQM	Phelipanche aegyptiaca
GFQN	Melastoma malabathricum
GFQO	Zoysia japonica
GFQP	Eriocrania semipurpurella
GFQQ	Thrips tabaci
GFQR	Aloe vera
GFRL	Phyllomimus sinicus
GFRM	Digitaria sanguinalis
GFRN	Paracentrotus lividus
GFRO	Montipora capitata
GFRP	Penaeus vannamei
GFRQ	Ocimum tenuiflorum
GFRR	Ocimum tenuiflorum
GFRS	Ocimum tenuiflorum
GFRT	Penaeus penicillatus
GFRU	Ocimum tenuiflorum
GFRV	Plutella xylostella
GFRW	Syngnathus scovelli
GFRX	Panax notoginseng
GFRY	Notospermus geniculatus
GFRZ	Symsagittifera roscoffensis
GFSA	Hofstenia miamia
GFSB	Hypericum perforatum
GFSC	Phoronis australis
GFSD	Eumetopias jubatus
GFSE	Gampsocleis gratiosa
GFSF	Trichoplax sp. H2
GFSG	Trichoplax adhaerens
GFSH	Ocimum tenuiflorum
GFSI	Halisarca caerulea
GFSJ	Hypericum androsaemum
GFSK	Hypericum kalmianum
GFSL	Camellia sasanqua
GFSM	Anolis carolinensis
GFSN	Ocimum tenuiflorum
GFSO	Hypericum annulatum
GFSP	Hypericum perforatum
GFSQ	Hypericum tomentosum
GFSR	Lolium perenne
GFSS	Perameles nasuta
GFST	Toxicodendron radicans subsp. radicans
GFSU	Pecoramyces ruminatium
GFSV	Acrochaetium humile
GFSW	Acrochaetium luxurians
GFSX	Acrochaetium secundatum
GFSY	Audouinella sp. 1hermannii
GFSZ	Grania efflorescens
GFTA	Rhodochorton purpureum
GFTB	Rhodochorton sp. 1SJuan
GFTC	Meiodiscus spetsbergensis
GFTD	Rubrointrusa membranacea
DQIR	Sus scrofa
GAAA	Latimeria chalumnae
GAAB	Agrilus planipennis
GAAC	Camellia sinensis var. sinensis
GAAD	Misgurnus anguillicaudatus
GAAF	Macrosiphum euphorbiae
GAAG	Panax ginseng
GAAH	Papio hamadryas
GAAI	Ovis aries
GAAJ	Phleum pratense
GAAK	Belgica antarctica
GAAL	Sparus aurata
GAAM	Histomonas meleagridis
GAAN	Allium cepa
GAAO	Allium cepa
GAAP	Bactrocera dorsalis
GAAQ	Solea solea
GAAR	Oesophagostomum dentatum
GAAS	Oesophagostomum dentatum
GAAT	Durinskia baltica
GAAU	Agrotis ipsilon
GAAV	Nemurella pictetii
GAAW	Humulus lupulus
GAAX	Forficula auricularia
GAAY	Lonicera japonica
GAAZ	Crotalus horridus
GABA	Zorotypus gurneyi
GABB	Archaeopsylla erinacei
GABC	Pan troglodytes
GABD	Pan troglodytes
GABE	Pan troglodytes
GABF	Pan troglodytes
GABG	Ipomoea purpurea
GABH	Musa ABB Group
GABI	Puccinellia tenuiflora
GABJ	Caragana korshinskii
GABK	Sialis lutaria
GABL	Camelina sativa
GABM	Sus scrofa
GABN	Sus scrofa
GABO	Camelina sativa
GABP	Lingulodinium polyedra
GABQ	Olea europaea
GABR	Kryptoperidinium foliaceum
GABS	Musca domestica
GABT	Cocos nucifera
GABU	Chilodonella uncinata
GABV	Corallomyxa tenera
GABW	Subulatomonas tetraspora
GABX	Dendroctonus ponderosae
GABY	Anthonomus grandis
GABZ	Desmodus rotundus
GACA	Pohlia nutans
GACB	Lotus corniculatus
GACC	Sus scrofa
GACD	Catharanthus roseus
GACE	Rauvolfia serpentina
GACF	Camptotheca acuminata
GACG	Picea sitchensis
GACH	Chromolaena odorata
GACI	Uromyces appendiculatus
GACJ	Diaphorina citri
GACK	Rhipicephalus pulchellus
GACL	Brachionus calyciflorus
GACM	Phakopsora pachyrhizi Thai1
GACN	Gerbera hybrid cultivar
GACO	Priacma serrata
GACP	Micropterix calthella
GACQ	Brachionus calyciflorus
GACR	Ips typographus
GACS	Oesophagostomum dentatum
GACT	Anolis carolinensis
GACU	Nevrorthus apatelios
GACV	Philopotamus ludificatus
GACW	Carabus granulatus
GACX	Raphidia ariadne
GACY	Mengenilla moldrzyki
GACZ	Tipula maxima
GADA	Xyela alpigena
GADB	Nannochorista philpotti
GADC	Plukenetia volubilis
GADD	Neoporphyra haitanensis
GADE	Cherax quadricarinatus
GADF	Ziziphus jujuba
GADG	Placopecten magellanicus
GADH	Corydalinae sp. KMRSPBM-2012
GADI	Ixodes ricinus
GADJ	Grapholita dimorpha
GADK	Grapholita molesta
GADL	Carposina sasakii
GADM	Drosophila malerkotliana malerkotliana
GADN	Anolis carolinensis
GADO	Anolis carolinensis
GADP	Drosophila ercepeae
GADQ	Drosophila malerkotliana pallens
GADR	Drosophila pseudoananassae nigrens
GADS	Drosophila merina
GADT	Camelus dromedarius
GADU	Camelus dromedarius
GADV	Camelus dromedarius
GADW	Camelus dromedarius
GADX	Camelus dromedarius
GADY	Camelus dromedarius
GADZ	Camelus dromedarius
GAEA	Camelus dromedarius
GAEB	Camelus dromedarius
GAEC	Anolis carolinensis
GAED	Anolis carolinensis
GAEE	Desmodus rotundus
GAEF	Triticum aestivum
GAEG	Lithobates clamitans
GAEH	Ruditapes philippinarum
GAEI	Pseudacris regilla
GAEJ	Drosophila pseudoananassae pseudoananassae
GAEK	Pseudotsuga menziesii var. menziesii
GAEM	Mytilus galloprovincialis
GAEN	Mytilus galloprovincialis
GAEO	Pissodes strobi
GAEP	Micrurus fulvius
GAEQ	Enallagma hageni
GAER	Arachis hypogaea
GAES	Camelus bactrianus
GAET	Camelus bactrianus
GAEU	Camelus bactrianus
GAEV	Camelus bactrianus
GAEW	Camelus bactrianus
GAEX	Camelus bactrianus
GAEY	Camelus bactrianus
GAEZ	Camelus bactrianus
GAFA	Camelus bactrianus
GAFB	Camelina sativa
GAFC	Capra hircus
GAFD	Anolis carolinensis
GAFE	Anopheles sinensis
GAFF	Medicago sativa
GAFH	Paratrimastix pyriformis
GAFI	Dendroctonus frontalis
GAFJ	Elaeis guineensis
GAFK	Anolis carolinensis
GAFL	Anolis carolinensis
GAFM	Anolis carolinensis
GAFN	Anolis carolinensis
GAFO	Cladocopium sp. clade C
GAFP	Symbiodinium sp. clade D
GAFQ	Elodea nuttallii
GAFR	Polistes canadensis
GAFS	Astacus leptodactylus
GAFT	Channa striata
GAFU	Spodoptera exigua
GAFV	Arthrinium malaysianum
GAFW	Dendroctonus ponderosae
GAFX	Dendroctonus ponderosae
GAFY	Astacus leptodactylus
GAFZ	Anolis carolinensis
GAGA	Anolis carolinensis
GAGB	Anolis carolinensis
GAGC	Anolis carolinensis
GAGD	Amblyomma americanum
GAGE	Arthrinium malaysianum
GAGF	Chrysopa pallens
GAGG	Anolis carolinensis
GAGH	Osmia cornuta
GAGI	Abdopus aculeatus
GAGJ	Hapalochlaena maculosa
GAGK	Uroteuthis noctiluca
GAGL	Octopus cyanea
GAGM	Pareledone turqueti
GAGN	Sepioteuthis australis
GAGO	Octopus kaurna
GAGP	Sepia pharaonis
GAGQ	Sepia latimanus
GAGR	Nannochloropsis gaditana
GAGS	Bithynia siamensis goniomphalos
GAGT	Anguilla japonica
GAGU	Panonychus citri
GAGV	Fritillaria cirrhosa
GAGW	Ophiocordyceps sinensis
GAGX	Ameiurus nebulosus
GAGY	Odocoileus virginianus
GAGZ	Acanthophis wellsi
GAHA	Brachyurophis roperi
GAHB	Cacophis squamulosus
GAHC	Denisonia devisi
GAHD	Echiopsis curta
GAHE	Furina ornata
GAHF	Hemiaspis signata
GAHG	Hoplocephalus bungaroides
GAHH	Pseudonaja modesta
GAHI	Suta fasciata
GAHJ	Vermicella annulata
GAHK	Jatropha curcas
GAHL	Sinocyclocheilus anophthalmus
GAHM	Armillaria ostoyae RNA1
GAHN	Drosophila serrata
GAHO	Sinocyclocheilus angustiporus
GAHP	Ostrinia nubilalis
GAHQ	Ostrinia scapulalis
GAHR	Hormogaster samnitica
GAHS	Hormogaster elisae
GAHT	Agave deserti
GAHU	Agave tequilana
GAHV	Nelumbo nucifera
GAHW	Elliptio complanata
GAHX	Mikrocytos mackini
GAHY	Rhodnius prolixus
GAHZ	Salicornia europaea
GAIA	Salicornia europaea
GAIB	Nothobranchius furzeri
GAIC	Solanum torvum
GAID	Oreochromis niloticus
GAIE	Chlamydomonas moewusii
GAIF	Dermanyssus gallinae
GAIG	Arachis hypogaea
GAIH	Conus victoriae
GAII	Alexandrium tamarense
GAIJ	Dinophysis acuminata
GAIK	Alexandrium tamarense
GAIL	Gymnodinium catenatum
GAIM	Geminigera cryophila
GAIN	Mesodinium rubrum
GAIO	Pyrodinium bahamense var. compressum
GAIP	Litchi chinensis
GAIQ	Alexandrium tamarense
GAIR	Puccinia striiformis f. sp. tritici
GAIS	Puccinia striiformis f. sp. tritici
GAIT	Alexandrium tamarense
GAIU	Alexandrium tamarense
GAIV	Alexandrium tamarense
GAIW	Ganaspis sp. G1
GAIX	Pararge aegeria
GAIY	Puccinia striiformis f. sp. tritici
GAIZ	Gryllus firmus
GAJA	Leptopilina boulardi
GAJB	Alexandrium tamarense
GAJC	Leptopilina heterotoma
GAJD	Ursus maritimus
GAJE	Avena sativa
GAJF	Equus caballus
GAJG	Alexandrium tamarense
GAJH	Elaeis guineensis
GAJI	Pseudopyrenochaeta lycopersici CRA-PAV_ER 1211
GAJJ	Anoplopoma fimbria
GAJK	Tripterygion delaisi
GAJL	Triticum aestivum
GAJM	Xibalbanus tulumensis
GAJN	Conus geographus
GAJO	Fundulus heteroclitus
GAJP	Hyalella azteca
GAJQ	Hyalella azteca
GAJR	Gentiana macrophylla
GAJS	Chilo suppressalis
GAJT	Coffea arabica
GAJU	Coffea racemosa
GAJV	Anoplocnemis curvipes
GAJW	Aphis craccivora
GAJX	Clavigralla tomentosicollis
GAJY	Megalurothrips sjostedti
GAJZ	Prunus avium
GAKA	Nitzschia sp. ChengR-2013
GAKB	Bactrocera oleae
GAKC	Silene latifolia
GAKD	Melita plumulosa
GAKE	Thlaspi arvense
GAKF	Amoebidium parasiticum JAP-7-2
GAKG	Cotesia vestalis
GAKH	Vitis vinifera
GAKI	Trametes sanguinea
GAKJ	Sitodiplosis mosellana
GAKK	Nothapodytes nimmoniana
GAKL	Triticum urartu
GAKM	Triticum turgidum
GAKN	Schmidtea mediterranea
GAKO	Platichthys stellatus
GAKP	Bactrocera dorsalis
GAKQ	Crotalus oreganus helleri
GAKR	Crotalus oreganus helleri
GAKS	Crotalus oreganus helleri
GAKT	Cupiennius salei
GAKU	Dendrocoelum lacteum
GAKV	Schmidtea mediterranea
GAKW	Glomeris pustulata
GAKX	Symphylella vulgaris
GAKY	Symbiodinium sp. A1
GAKZ	Procotyla fluviatilis
GALA	Psorophora albipes
GALB	Sinonovacula constricta
GALC	Crotalus oreganus helleri
GALD	Agapanthus praecox subsp. orientalis
GALE	Spraguea lophii
GALF	Enchytraeus crypticus
GALG	Australobuthus xerolimniorum
GALH	Cercophonius squama
GALI	Urodacus manicatus
GALJ	labyrinthulid quahog parasite QPX
GALK	Isometroides vescus
GALL	Lychas buchari
GALM	Aspidistra saxicola
GALN	Persicaria minor
GALO	Apis mellifera carnica
GALP	Drosophila miranda
GALQ	gut metagenome
GALR	Pyrus pyrifolia
GALS	Panonychus citri
GALT	gut metagenome
GALU	Crataegus pinnatifida
GALV	Gossypium hirsutum
GALW	Dugesia japonica
GALX	Anoplophora glabripennis
GALY	Ipomoea purpurea
GALZ	Actinidia chinensis
GAMA	Actinidia chinensis
GAMB	Actinidia chinensis
GAMC	Ceratitis capitata
GAMD	Anopheles aquasalis
GAME	Atractaspis aterrima
GAMF	Atractaspis aterrima
GAMG	Prymnesium parvum
GAMH	Salicornia europaea
GAMI	Salicornia europaea
GAMJ	Pisum sativum
GAMK	Phaseolus vulgaris
GAML	Lates calcarifer
GAMM	Orchesella cincta
GAMN	Folsomia candida
GAMO	Porichthys notatus
GAMP	Callithrix jacchus
GAMQ	Callithrix jacchus
GAMR	Callithrix jacchus
GAMS	Callithrix jacchus
GAMT	Callithrix jacchus
GAMU	Lates calcarifer
GAMV	Dermacentor reticulatus
GAMW	Rhazya stricta
GAMX	Branchiostoma floridae
GAMY	Craspedacusta sowerbii
GAMZ	Nematostella vectensis
GANA	Hydractinia polyclina
GANB	Ectopleura larynx
GANC	Hydra vulgaris
GAND	Lumbricus terrestris
GANE	Stevia rebaudiana
GANF	Momordica charantia
GANG	Momordica charantia
GANH	Microplitis demolitor
GANI	Karelinia caspia
GANJ	Mauremys reevesii
GANK	Paeonia suffruticosa
GANL	Latrodectus tredecimguttatus
GANM	Nilaparvata lugens
GANN	Tetraselmis subcordiformis
GANO	Corethrella appendiculata
GANP	Ixodes ricinus
GANQ	Acanthamoeba castellanii
GANR	Macrotyloma uniflorum
GANS	Dinoponera quadriceps
GANT	Capra hircus
GANU	Capra hircus
GANV	Capra hircus
GANW	Capra hircus
GANX	Capra hircus
GANY	Capra hircus
GANZ	Capra hircus
GAOA	Capra hircus
GAOB	Capra hircus
GAOC	Capra hircus
GAOD	Capra hircus
GAOE	Capra hircus
GAOF	Capra hircus
GAOG	Capra hircus
GAOH	Capra hircus
GAOI	Capra hircus
GAOJ	Capra hircus
GAOK	Cercis gigantea (nom. inval.)
GAOL	Hydra vulgaris
GAOM	Macrosiphum euphorbiae
GAON	Cuscuta pentagona
GAOO	Prosopis alba
GAOP	Pachypsylla venusta
GAOQ	Spodoptera exigua
GAOR	Spodoptera exigua
GAOS	Notholithocarpus densiflorus
GAOT	Zantedeschia aethiopica
GAOU	Trifolium pratense
GAOV	Cynopterus sphinx
GAOW	Jatropha curcas
GAOX	Pecten maximus
GAOY	Oncorhynchus mykiss
GAOZ	Myotis ricketti
GAPA	Brevibacillus borstelensis
GAPB	Evechinus chloroticus
GAPC	Mangifera indica
GAPD	Chlorella sorokiniana
GAPE	Brassicogethes aeneus
GAPF	Callithrix jacchus
GAPG	Callithrix jacchus
GAPH	Callithrix jacchus
GAPI	Callithrix jacchus
GAPJ	Callithrix jacchus
GAPK	Platichthys stellatus
GAPL	Sitobion avenae
GAPM	Rattus norvegicus
GAPN	Cylindrotheca closterium
GAPO	Bos taurus
GAPP	Bemisia tabaci
GAPQ	Bemisia tabaci
GAPR	Diadromus collaris
GAPS	Latimeria menadoensis
GAPT	Ectopsocus briggsi
GAPU	Phaedon cochleariae
GAPV	Macaca mulatta
GAPW	Aedes albopictus
GAPX	Amaranthus tricolor
GAPY	Amaranthus tricolor
GAPZ	Amaranthus tricolor
GAQA	Amaranthus tricolor
GAQB	food metagenome
GAQC	Cuscuta suaveolens
GAQD	Cuscuta pentagona
GAQE	Trittame loki
GAQF	Cotesia vestalis
GAQG	Gallus gallus
GAQH	Monodelphis domestica
GAQJ	Ostrinia furnacalis
GAQK	Hynobius chinensis
GAQL	Lates calcarifer
GAQM	Macaca mulatta
GAQN	Pan troglodytes
GAQO	Bos taurus
GAQP	Gardenia jasminoides
GAQQ	Bithynia siamensis goniomphalos
GAQR	Pinus massoniana
GAQS	Morone americana
GAQT	Corticium candelabrum
GAQU	Sycon coactum
GAQV	Trypoxylus dichotomus
GAQW	Onthophagus nigriventris
GAQX	Graminella nigrifrons
GAQY	Brassica oleracea var. capitata
GAQZ	Landoltia punctata
GARA	Miichthys miiuy
GARB	Athetis lepigone
GARC	Athetis lepigone
GARD	Athetis lepigone
GARE	Bouteloua dactyloides
GARF	Chrysomela populi
GARG	Athetis lepigone
GARH	Procambarus clarkii
GARJ	Popillia japonica
GARK	Popillia japonica
GARL	Spodoptera exigua
GARM	Camellia sinensis var. sinensis
GARN	Musca domestica
GARO	Echinogammarus veneris
GARP	Bemisia tabaci
GARQ	Bemisia tabaci
GARR	Isatis tinctoria
GARS	Brachionus manjavacas
GART	Glycera tridactyla
GARU	Glycera tridactyla
GARV	Glycera fallax
GARW	Eucyclops serrulatus
GARX	Silene latifolia
GARY	Stylophora pistillata
GARZ	Vicia faba
GASA	Vicia faba
GASB	Glycera dibranchiata
GASC	Neolamarckia cadamba
GASD	Heterodera schachtii
GASE	Prorhinotermes simplex
GASF	Ancylostoma ceylanicum
GASG	Yponomeuta evonymella
GASH	Scolopendra morsitans
GASI	Ethmostigmus rubripes
GASJ	Ethmostigmus rubripes
GASK	Scolopendra alternans
GASL	Cormocephalus westwoodi
GASM	Tetramorium bicarinatum
GASN	Thermobia domestica
GASO	Tricholepidion gertschi
GASP	Pteridium aquilinum subsp. aquilinum
GASQ	Tetrix subulata
GASR	Thereuopoda longicornis
GASS	Platycentropus radiatus
GAST	Polyommatus icarus
GASU	Acropora cervicornis
GASV	Notostira elongata
GASW	Mantis religiosa
GASX	Folsomia candida
GASY	Dyseriocrania subpurpurella
GASZ	Noccaea caerulescens
GATA	Meloe violaceus
GATB	Metallyticus splendidus
GATC	Nemophora degeerella
GATD	Pogonognathellus sp. AD-2013
GATE	Arachis hypogaea
GATF	Esox lucius
GATG	Corydalus cornutus
GATH	Bittacus pilicornis
GATI	Bombylius major
GATJ	Bibio marci
GATK	Pongo pygmaeus
GATL	Ornithorhynchus anatinus
GATM	Loxodonta africana
GATN	Rattus norvegicus
GATO	Notamacropus eugenii
GATP	Mus musculus
GATQ	Gallus gallus
GATR	Gorilla gorilla
GATS	Monodelphis domestica
GATT	Callithrix jacchus
GATU	Baetis sp. AD-2013
GATV	Perla marginata
GATW	Aleochara curtula
GATX	Annulipalpia sp. AD-2013
GATY	Chrysis viridula
GATZ	Sminthurus viridis
GAUA	Hemiaulus sinensis
GAUB	Leptocylindrus danicus
GAUC	Bemisia tabaci
GAUD	Triparma pacifica
GAUE	Anurida maritima
GAUF	Leuctra sp. AD-2013
GAUG	Meinertellus cundinamarcensis
GAUH	Panorpa vulgaris
GAUI	Subilla sp. AD-2014
GAUJ	Orussus abietinus
GAUK	Ephemera danica
GAUL	Candidatus Portiera aleyrodidarum
GAUM	Machilis hrabei
GAUN	Cercopis vulnerata
GAUO	Velia caprai
GAUP	Cotesia vestalis
GAUQ	Ophiocoma echinata
GAUR	Lytechinus variegatus
GAUS	Asterias forbesi
GAUT	Sclerodactyla briareus
GAUU	Asterias rubens
GAUV	Acanthosoma haemorrhoidale
GAUW	Apachyus charteceus
GAUX	Ceuthophilus sp. AD-2013
GAUY	Gyrinus marinus
GAUZ	Stenobothrus lineatus
GAVA	Triarthria setipennis
GAVB	Triodia sylvina
GAVC	Leptasterias sp. AR-2014
GAVD	Ostrinia nubilalis
GAVE	Echinaster spinulosus
GAVF	Echinarachnius parma
GAVI	Marthasterias glacialis
GAVJ	Asterias amurensis
GAVK	Patiria pectinifera
GAVL	Asterias amurensis
GAVM	Hydroptila sp. AD-2013
GAVN	Pisaster ochraceus
GAVO	Apostichopus californicus
GAVP	Henricia sp. AR-2014
GAVQ	Luidia clathrata
GAVR	Sphaerechinus granularis
GAVS	Apostichopus japonicus
GAVT	Patiria pectinifera
GAVU	Strongylocentrotus purpuratus
GAVV	Pseudomallada prasinus
GAVW	Epiophlebia superstes
GAVX	Timema cristinae
GAVY	Rhinolophus ferrumequinum
GAVZ	Tripterygium wilfordii
GAWA	Prunus armeniaca
GAWB	Patiria miniata
GAWC	Aretaon asperrimus
GAWD	Medauroidea extradentata
GAWE	Ramulus artemis
GAWF	Sipyloidea sipylus
GAWG	Extatosoma tiaratum
GAWH	Hydractinia symbiolongicarpus
GAWI	Delia antiqua
GAWJ	Peruphasma schultei
GAWK	Ceratophyllus gallinae
GAWM	Culicoides sonorensis
GAWN	Galloisiana yuasai
GAWO	Kaupichthys hyoproroides
GAWP	Grylloblatta bifratrilecta
GAWQ	Okanagana villosa
GAWR	Menopon gallinae
GAWS	Periplaneta americana
GAWT	Empusa pennata
GAWU	Aposthonia japonica
GAWV	Candidatus Portiera aleyrodidarum
GAWW	Tenthredo koehleri
GAWX	Trialeurodes vaporariorum
GAWY	Oropsylla silantiewi
GAWZ	Gryllotalpa sp. AD-2013
GAXA	Isonychia bicolor
GAXB	Tanzaniophasma sp. AD-2013
GAXC	Thrips palmi
GAXD	Frankliniella occidentalis
GAXE	Acerentomon sp. AD-2013
GAXF	Planococcus citri
GAXG	Gynaikothrips ficorum
GAXH	Parides eurimedes
GAXI	Tetrodontophora bielanensis
GAXJ	Occasjapyx japonicus
GAXK	Calanus finmarchicus
GAXL	Chyphotes mellipes
GAXM	Mischocyttarus flavitarsis
GAXN	Sceliphron caementarium
GAXO	Argochrysis armilla
GAXP	Sphaeropthalma orestes
GAXQ	Pseudomasaris vespoides
GAXR	Stigmatomma oregonense
GAXS	Pepsis grossa
GAXT	Crioscolia alcione
GAXU	Capsicum annuum
GAXV	Capsicum annuum
GAXW	Euroleon nostras
GAXX	Rhyacophila fasciata
GAXY	Leptopilina clavipes
GAXZ	Trichocera saltator
GAYA	Spiralizoros caudelli
GAYB	Zygaena fausta
GAYC	Osmylus fulvicephalus
GAYD	Blaberus atropos
GAYE	Frankliniella cephalica
GAYF	Nilaparvata lugens
GAYG	Pinus pinaster
GAYH	Conwentzia psociformis
GAYI	Xenophysella greensladeae
GAYJ	Atelura formicaria
GAYK	Boreus hyemalis
GAYL	Cosmioperla kuna
GAYM	Calopteryx splendens
GAYN	Campodea augens
GAYO	Cordulegaster boltonii
GAYP	Ctenocephalides felis
GAYQ	Forficula auricularia
GAYR	Solanum melongena
GAYS	Solanum incanum
GAYT	Ficus carica
GAYU	Lolium rigidum
GAYV	Liposcelis bostrychophila
GAYW	Amblyomma americanum
GAYX	Lolium perenne
GAYY	Acanthocasuarina muellerianae
GAYZ	Ranatra linearis
GAZA	Haploembia palaui
GAZB	Lepicerus sp. AD-2013
GAZC	Neolamprologus brichardi
GAZD	Lipara lucens
GAZE	Mastotermes darwiniensis
GAZF	Essigella californica
GAZG	Eurylophella sp. AD-2013
GAZH	Inocellia crassicornis
GAZI	Neolamprologus brichardi
GAZJ	Neolamprologus brichardi
GAZK	Neolamprologus brichardi
GAZL	Aplysia californica
GAZM	Stylops melittae
GAZN	Cryptocercus wrighti
GAZO	Anneissia japonica
GAZP	Eucidaris tribuloides
GAZQ	Aretaon asperrimus
GAZR	Stegodyphus mimosarum
GAZS	Acanthoscurria geniculata
GAZT	Prosarthria teretrirostris
GAZU	Brachycistis timberlakei
GAZV	Apis mellifera
GAZW	Pseudotsuga menziesii
GAZX	Caligus rogercresseyi
GAZY	Morone chrysops
GAZZ	Ammopiptanthus mongolicus
GBAA	Morone saxatilis
GBAB	Musca domestica
GBAC	Plutella xylostella
GBAD	Boechera gunnisoniana
GBAE	Gambusia affinis
GBAF	Neolamprologus brichardi
GBAG	Neolamprologus brichardi
GBAH	Chlamydomonas acidophila
GBAI	Amblyomma americanum
GBAJ	Amblyomma americanum
GBAK	Amblyomma americanum
GBAL	Amblyomma americanum
GBAM	Kaupichthys hyoproroides
GBAN	Maylandia zebra
GBAO	Oreochromis niloticus
GBAP	Maylandia zebra
GBAQ	Aplysia californica
GBAR	Oreochromis niloticus
GBAS	Telchin licus
GBAT	Ictalurus punctatus
GBAU	Agropyron cristatum
GBAV	Aplysia californica
GBAW	Haplochromis burtoni
GBAX	Oryctolagus cuniculus
GBAY	Oreochromis niloticus
GBAZ	Oreochromis niloticus
GBBA	Saccharina latissima
GBBB	Zonotrichia albicollis
GBBC	Zonotrichia albicollis
GBBD	Zonotrichia albicollis
GBBE	Aplysia californica
GBBF	Haplochromis burtoni
GBBG	Aplysia californica
GBBH	Chinchilla lanigera
GBBI	Triatoma infestans
GBBJ	Haplochromis burtoni
GBBK	Amblyomma cajennense
GBBL	Amblyomma parvum
GBBM	Amblyomma triste
GBBN	Ixodes scapularis
GBBO	Rhipicephalus microplus
GBBP	Teleopsis dalmanni
GBBQ	Teleopsis whitei
GBBR	Rhipicephalus microplus
GBBS	Anolis carolinensis
GBBT	Maylandia zebra
GBBU	Oreochromis niloticus
GBBV	Aplysia californica
GBBW	Aplysia californica
GBBX	Oreochromis niloticus
GBBY	Spodoptera litura
GBBZ	Camellia sinensis
GBCA	Oryctolagus cuniculus
GBCB	Chinchilla lanigera
GBCC	Chinchilla lanigera
GBCD	Oryctolagus cuniculus
GBCE	Chinchilla lanigera
GBCF	Nitzschia sp. ChengR-2013
GBCG	Chloris chloris
GBCH	Oryctolagus cuniculus
GBCI	Oryctolagus cuniculus
GBCJ	Oryctolagus cuniculus
GBCK	Oryctolagus cuniculus
GBCL	Hypsizygus marmoreus
GBCM	Oryctolagus cuniculus
GBCN	Oryctolagus cuniculus
GBCO	Neolamprologus brichardi
GBCP	Oreochromis niloticus
GBCQ	Chinchilla lanigera
GBCR	Dioscorea zingiberensis
GBCS	Latrodectus hesperus
GBCT	Oryctolagus cuniculus
GBCU	Aphidius ervi
GBCV	Mangifera indica
GBCW	Agrotis segetum
GBCX	Dastarcus helophoroides
GBCY	Caulerpa taxifolia
GBCZ	Aplysia californica
GBDA	Aplysia californica
GBDB	Oreochromis niloticus
GBDC	Oreochromis niloticus
GBDD	Anolis carolinensis
GBDE	Anolis carolinensis
GBDF	Chinchilla lanigera
GBDG	Maylandia zebra
GBDH	Haplochromis burtoni
GBDI	Chinchilla lanigera
GBDJ	Chinchilla lanigera
GBDK	Chinchilla lanigera
GBDL	Haplochromis burtoni
GBDM	Helicoverpa armigera
GBDN	Dahlia pinnata
GBDO	Kerria lacca
GBDP	Kerria lacca
GBDQ	Petunia integrifolia subsp. inflata
GBDR	Petunia integrifolia subsp. inflata
GBDS	Petunia integrifolia subsp. inflata
GBDT	Anolis carolinensis
GBDU	Anolis carolinensis
GBDV	Anolis carolinensis
GBDW	Anolis carolinensis
GBDX	Brassica rapa
GBDY	Kerria lacca
GBDZ	Locusta migratoria manilensis
GBEA	Nicotiana tabacum
GBEB	Nasonia vitripennis
GBEC	Nasonia giraulti
GBED	Pyrus pyrifolia
GBEE	Schmidtea mediterranea
GBEF	Solanum melongena
GBEG	Solanum torvum
GBEH	Podocoryna carnea
GBEI	Astacus leptodactylus
GBEJ	Agaricus subrufescens
GBEK	Mesostigma viride
GBEL	Ichthyomyzon fossor
GBEM	Ichthyomyzon castaneus
GBEN	Elodea nuttallii
GBEO	Anopheles sinensis
GBEP	Brassica juncea
GBEQ	Brassica juncea
GBER	Euschistus heros
GBES	Dichelops melacanthus
GBET	Pelophylax nigromaculatus
GBEU	Telenomus podisi
GBEV	Procambarus clarkii
GBEW	Micrurus fulvius
GBEX	Crotalus adamanteus
GBEY	Bactrocera minax
GBEZ	Tetraselmis sp. GSL018
GBFA	Chinavia ubica
GBFB	Calanus finmarchicus
GBFC	Cupiennius salei
GBFD	Hydra oligactis
GBFE	Locusta migratoria
GBFF	Conus sanguinolentus
GBFG	Conus sanguinolentus
GBFH	Conus lividus
GBFI	Conus lividus
GBFJ	Conus sp. n. 1 NP-2014
GBFK	Conus sp. n. 1 NP-2014
GBFL	Vaccinium macrocarpon
GBFM	Micropterus floridanus
GBFN	Paeonia lactiflora
GBFO	Micropterus salmoides
GBFP	marine metagenome
GBFQ	Oryzias melastigma
GBFR	Oryzias melastigma
GBFS	Oryzias melastigma
GBFT	Oryzias melastigma
GBFU	Oryzias melastigma
GBFV	Oryzias melastigma
GBFW	Oryzias melastigma
GBFX	Oryzias melastigma
GBFY	Oryzias melastigma
GBFZ	marine metagenome
GBGA	Micropterus salmoides salmoides
GBGB	Orius laevigatus
GBGC	Limnoperna fortunei
GBGD	Panstrongylus megistus
GBGE	Oryzias melastigma
GBGF	Nicotiana attenuata
GBGG	Themira biloba
GBGH	Polypodium hydriforme
GBGI	Kudoa iwatai
GBGJ	Allium cepa
GBGK	Cocos nucifera
GBGL	Cocos nucifera
GBGM	Cocos nucifera
GBGN	Ceratopteris richardii
GBGO	Eurytemora affinis
GBGP	Clytia hemisphaerica
GBGQ	Schmidtea mediterranea
GBGR	Punica granatum
GBGS	Dosidicus gigas
GBGT	Sepioteuthis lessoniana
GBGU	Sepia esculenta
GBGV	Polistes metricus
GBGW	Symbiodinium sp. A2
GBGX	Phytophthora cactorum
GBGY	Paeonia suffruticosa
GBGZ	Solanum melongena
GBHA	Pampus argenteus
GBHB	Teleogryllus commodus
GBHC	Salmo salar
GBHD	Salmo salar
GBHE	Salmo salar
GBHF	Salmo salar
GBHG	Calotropis procera
GBHH	Euprymna scolopes
GBHI	Camellia oleifera
GBHJ	Withania somnifera
GBHK	Arachis hypogaea
GBHL	Tinospora cordifolia
GBHM	Agave americana
GBHN	Colaphellus bowringi
GBHO	Lygus hesperus
GBHP	Hevea brasiliensis
GBHQ	Cephalotaxus hainanensis
GBHR	Mesocricetus auratus
GBHS	Mesocricetus auratus
GBHT	Halyomorpha halys
GBHU	Echis coloratus
GBHV	Eublepharis macularius
GBHW	Opheodrys aestivus
GBHX	Pantherophis guttatus
GBHY	Python regius
GBHZ	Eublepharis macularius
GBIA	Opheodrys aestivus
GBIB	Pantherophis guttatus
GBIC	Python regius
GBID	Blattella germanica
GBIE	Anthoxanthum odoratum
GBIF	Larimichthys crocea
GBIG	Agrocybe salicacicola
GBIH	Ixodes ricinus
GBII	Bemisia tabaci
GBIJ	Bemisia tabaci
GBIK	Acanthis flammea
GFTE	Devaleraea mollis
GFTF	Devaleraea ramentacea
GFTG	Palmaria hecatensis
GFTH	Palmaria palmata
GFTI	Rhodonematella subimmersa
GFTJ	Rhodophysema elegans
GFTK	Rhodothamniella floridula
GFTL	Carya illinoinensis
GFTM	Camontagnea oxyclada
GFTN	Acrochaetiales sp. 1Aus
GFTO	Halisarca caerulea
GFTP	Halisarca caerulea
GFTQ	Halisarca caerulea
GFTR	Panstrongylus lignarius
GFTS	Prasiola crispa
GFTT	Haliotis laevigata
GFTU	Euscelidius variegatus
GFTV	Malpolon insignitus
GFTW	Parthenium argentatum
GFTX	Ulva lactuca
GFTY	Camellia sinensis
GFTZ	Anneslea fragrans
GFUA	Epischura baikalensis
GFUB	Podisus maculiventris
GFUC	Homarus americanus
GFUD	Neocalanus flemingeri
GFUE	Brainea insignis
GFUF	Diospyros kaki
GFUG	ant metagenome
GFUH	Amphizoa lecontei
GFUI	Liopterus haemorrhoidalis
GFUJ	Batrachomatus nannup
GFUK	Hygrobia hermanni
GFUL	Arabidopsis halleri subsp. halleri
GFUM	Suaeda salsa
GFUN	Hygrobia nigra
GFUO	Aspidytes niobe
GFUP	Scenedesmus acutus
GFUQ	Phaeocystis antarctica
GFUR	Ulva lactuca
GFUS	Brassica rapa subsp. chinensis
GFUT	Calicophoron daubneyi
GFUU	Ulmus minor
GFUV	Anticarsia gemmatalis
GFUW	Oncorhynchus gorbuscha
GFUX	Solenopsis invicta
GFUY	Phoneutria nigriventer
GFUZ	Amphizoa insolens
GFVA	Mugilogobius chulae
GFVB	Thymallus thymallus
GFVC	Jatropha curcas
GFVD	Rhodiola rosea
GFVE	Rhodiola rosea
GFVF	Rhodiola rosea
GFVG	Argyrosomus regius
GFVH	Heliopora coerulea
GFVI	Aeschynomene evenia var. serrulata
GFVJ	Megathyrsus maximus
GFVK	Paulownia tomentosa
GFVL	Parhyale hawaiensis
GFVM	Eragrostis curvula
GFVN	Bicyclus anynana
GFVO	Termitomyces sp. MTP_Mn156
GFVP	Termitomyces sp. MTP_Mn156
GFVQ	Termitomyces sp. MTP_Mn156
GFVR	Termitomyces sp. MTP_Od127
GFVS	Termitomyces sp. MTP_Od127
GFVT	Termitomyces sp. MTP_Od127
GFVU	Termitomyces sp. MTP_Od128
GFVV	Termitomyces sp. MTP_Od128
GFVW	Termitomyces sp. MTP_Od128
GFVX	Nodipecten subnodosus
GFVY	Clitarchus hookeri
GFVZ	Ixodes ricinus
GFWA	Chlamydomonas acidophila
GFWB	Ambrosia artemisiifolia
GFWC	Viola albida var. takahashii
GFWD	Viola acuminata
GFWE	Papiliotrema laurentii RY1
GFWF	Viola verecunda
GFWG	Viola mandshurica
GFWH	Gloiopeltis furcata
GFWI	Helicoverpa armigera
GFWJ	Crepidula atrasolea
GFWK	Epipogium aphyllum
GFWL	Epipogium roseum
GFWM	Monotropa hypopitys
GFWN	Spirogyra pratensis
GFWO	Labidocera madurae
GFWP	Sogatella furcifera
GFWQ	Plodia interpunctella
GFWR	Cladolabes schmeltzii
GFWS	Ambrosia artemisiifolia
GFWT	Quercus ilex
GFWU	Cyprinus carpio
GFWV	Ornithodoros erraticus
GFWW	Bothrops moojeni
GFWX	Ischnura elegans
GFWY	Acartia tonsa
GFWZ	Centruroides hentzi
GFXA	Bathyberthella antarctica
GFXB	Metorchis orientalis
GFXC	Anoplophora chinensis
GFXD	Ipomoea trifida
GFXE	Panopea globosa
GFXF	Carcinus maenas
GFXG	Eutiarosporella tritici-australis
GFXH	Eutiarosporella darliae
GFXI	Eutiarosporella pseudodarliae
GFXJ	Gecarcoidea natalis
GFXK	Cynoglossus semilaevis
GFXL	Lithophaga lithophaga
GFXM	Bemisia tabaci
GFXN	Ipomoea trifida
GFXO	Ipomoea trifida
GFXP	Ruditapes decussatus
GFXQ	Apostichopus japonicus
GFXR	Viola orientalis
GFXS	Lachnolaimus maximus
GFXT	Asclepias syriaca
GFXU	Boreogadus saida
GFXV	Melanaphis sacchari
GFXW	Ettlia oleoabundans
GFXX	Mesostigma viride
GFXY	Klebsormidium flaccidum
GFXZ	Coleochaete scutata
GFYA	Zygnema circumcarinatum
GFYB	Alloteropsis semialata
GFYC	Oryza sativa
GFYD	Alloteropsis semialata
GFYE	Alloteropsis semialata
GFYF	Alloteropsis semialata
GFYG	Alloteropsis semialata
GFYH	Alloteropsis semialata
GFYI	Alloteropsis semialata
GFYJ	Alloteropsis semialata
GFYK	Alloteropsis semialata
GFYL	Alloteropsis semialata
GFYM	Eudiplozoon nipponicum
GFYN	Alloteropsis cimicina
GFYO	Alloteropsis angusta
GFYP	Panicum pygmaeum
GFYQ	Borassus flabellifer
GFYR	Corbicula fluminea
GFYS	Rhopilema esculentum
GFYT	Oenanthe oenanthe
GFYU	Ancoracysta twista
GFYV	Carcinus maenas
GFYW	Carcinus maenas
GFYX	insect metagenome
GFYY	Prionace glauca
GFYZ	Allium sativum
GFZA	ant metagenome
GFZB	Hevea brasiliensis subsp. brasiliensis
GFZC	Portunus sanguinolentus
GFZD	Rhipicephalus bursa
GFZE	Catharanthus roseus
GFZF	Chlorokybus atmophyticus
GFZG	Chara globularis
GFZI	Microplitis tuberculifer
GFZJ	Rhipicephalus bursa
GFZK	Rhipicephalus bursa
GFZL	Pinus tecunumanii
GFZM	Camellia chekiangoleosa
GFZN	Mytilus galloprovincialis
GFZP	Ambystoma mexicanum
GFZQ	Machimus arthriticus
GFZR	Eutolmus rufibarbis
GFZU	Laurencia pacifica
GFZV	Auricularia auricula-judae
GFZW	Taraxacum kok-saghyz
GFZX	Tinca tinca
GFZY	seawater metagenome
GFZZ	Heterodera glycines
GGAA	Nicrophorus orbicollis
GGAB	Vaccinium virgatum
GGAC	Foeniculum vulgare
GGAD	Mus spretus
GGAE	Vaccinium virgatum
GGAF	Pecten maximus
GGAG	Amrasca biguttula biguttula
GGAH	Trypoxylus dichotomus
GGAI	Persea americana
GGAJ	Colobanthus quitensis
GGAK	Monilinia fructicola
GGAL	Monilinia laxa
GGAM	Monilinia fructigena
GGAN	Dasyhelea sp. Cera B11
GGAO	Coregonus lavaretus
GGAP	Salvelinus alpinus
GGAQ	Salmo salar
GGAR	Salmo trutta
GGAS	Narenga porphyrocoma
GGAT	Limecola balthica balthica
GGAU	Pinus patula
GGAV	Scatopsidae sp. GD3
GGAW	Atrichopogon sp. Cera GD1
GGAX	Podonomus sp. Cul2
GGAY	Procladius villosimanus
GGAZ	Telmatopelopia nemorum
GGBA	Paraheptagyia tonnoiri
GGBB	Telmatogeton pectinata
GGBC	Polypedilum nubifer
GGBD	Cardiocladius sp. GF1
GGBE	Kiefferophyes invenustulus
GGBF	Austrothaumalea cf. denticulata Cul1
GGBG	cf. Paracnephia sp. Prosim 2
GGBH	Dixa sp. Dix1
GGBI	cf. Dixella/Nothodixa sp. Dix2
GGBJ	Corethrella calathicola
GGBK	Chaoborus flavidulus
GGBL	Toxorhynchites sp. Toxo
GGBM	Tripteroides aranoides
GGBN	Oncorhynchus mykiss
GGBO	Adelphocoris fasciaticollis
GGBP	Simulium sp. Sim Corn
GGBQ	Adelphocoris lineolatus
GGBR	freshwater metagenome
GGBS	Bactrocera dorsalis
GGBT	Delphinapterus leucas
GGBU	Adelphocoris suturalis
GGBV	Isodiametra pulchra
GGBW	Ginkgo biloba
GGBY	Caulanthus amplexicaulis
GGBZ	Caulanthus amplexicaulis
GGCA	Melibe leonina
GGCC	Porichthys notatus
GGCD	Globobulimina sp.
GGCE	Globobulimina sp.
GGCF	Pollicipes pollicipes
GGCG	Littorina littorea
GGCH	Pollicipes pollicipes
GGCI	Scomber colias
GGCK	Microplitis mediator
GGCL	Anguilla anguilla
GGCM	Hordeum vulgare subsp. vulgare
GGCN	Hordeum vulgare subsp. vulgare
GGCO	Hordeum vulgare
GGCP	Hordeum vulgare subsp. vulgare
GGCQ	Hordeum vulgare subsp. vulgare
GGCR	Hordeum vulgare subsp. vulgare
GGCS	Hordeum vulgare subsp. vulgare
GGCT	Hordeum vulgare subsp. vulgare
GGCU	Hordeum vulgare subsp. vulgare
GGCV	Hordeum vulgare subsp. vulgare
GGCW	Hordeum vulgare subsp. vulgare
GGCX	Hordeum vulgare subsp. vulgare
GGCY	Hordeum vulgare subsp. vulgare
GGCZ	Hordeum vulgare subsp. vulgare
GGDA	Hordeum vulgare subsp. vulgare
GGDB	Hordeum vulgare subsp. vulgare
GGDC	Hordeum vulgare subsp. vulgare
GGDD	Hordeum vulgare subsp. vulgare
GGDE	Hordeum vulgare subsp. vulgare
GGDF	Hordeum vulgare subsp. vulgare
GGDG	Hordeum vulgare subsp. vulgare
GGDH	Hordeum vulgare subsp. vulgare
GGDI	Hordeum vulgare subsp. vulgare
GGDJ	Hordeum vulgare subsp. vulgare
GGDK	Hordeum vulgare subsp. vulgare
GGDL	Hordeum vulgare subsp. vulgare
GGDM	Hordeum vulgare subsp. vulgare
GGDN	Hordeum vulgare subsp. spontaneum
GGDO	Hordeum vulgare subsp. spontaneum
GGDP	Hordeum vulgare subsp. spontaneum
GGDQ	Hordeum vulgare subsp. spontaneum
GGDR	Hordeum vulgare subsp. spontaneum
GGDS	Hordeum vulgare subsp. spontaneum
GGDT	Hordeum vulgare subsp. spontaneum
GGDU	Oncorhynchus tshawytscha
GGDV	Croton tiglium
GGDW	Scolopendra subspinipes
GGDX	Avena sativa
GGDY	Avena sativa
GGDZ	Sorghum halepense
GGEA	Agave amica
GGEB	Camellia sinensis
GGEC	Rhizophora mucronata
GGED	Lupinus angustifolius
GGEE	Falco sparverius
GGEF	seawater metagenome
GGEG	Papaipema speciosissima
GGEH	Papaipema sp. 4 SJO-2017
GGEI	Ciona savignyi
GGEJ	Copidosoma sosares
GGEK	Geosiphon pyriformis
GGEL	Crassostrea gigas
GGEM	Clausena excavata
GGEN	Thinopyrum intermedium
GGEO	Ctenopseustis obliquana
GGEP	Sarcophaga peregrina
GGEQ	Clonostachys rosea
GGER	Porites lutea
GGES	Porites lutea
GGET	Ctenopseustis herana
GGEU	Planotortrix excessana
GGEV	Planotortrix octo
GGEX	Pinus pinaster
GGEY	Patiria miniata
GGEZ	Heterobasidion occidentale
GGFA	Heterobasidion occidentale
GGFB	Laupala cerasina
GGFC	Solanum sisymbriifolium
GGFD	Charybdis feriata
GGFE	Potamopyrgus antipodarum
GGFF	Anopheles nuneztovari
GGFG	Myrmecia gulosa
GGFH	Ostrinia furnacalis
GGFI	Anguillicola crassus
GGFJ	Anopheles marajoara
GGFK	Anopheles triannulatus
GGFL	Anopheles darlingi
GGFM	Anopheles braziliensis
GGFN	Posidonia oceanica
GGFO	Lumnitzera littorea
GGFQ	Lumnitzera racemosa
GGFR	Gymnodraco acuticeps
GGFY	Ceanothus thyrsiflorus
GGFZ	Datisca glomerata
GGGA	Chlorella sp. BR2
GGGB	Edwardsiella carnea
GGGC	Metridium senile
GGGD	Edwardsiella carnea
GGGE	Scolanthus callimorphus
GGGH	Artocarpus altilis
GGGI	Leptopilina boulardi
GGGJ	Schistosoma haematobium
GGGK	Morchella importuna
GGGL	Heterodontus zebra
GGGM	Salix purpurea
GGGN	Citrus maxima
GGGO	Mimachlamys varia
GGGP	Bombus pyrosoma
GGGQ	Tagetes erecta
GGGR	Anguilla anguilla
GGGS	Spirobranchus lamarcki
GGGT	Amaranthus tuberculatus
GGGU	Zea mays
GGGV	Stentor polymorphus
GGGW	Amenia sp. RSM006
GGGX	Zea mays
GGGY	Bixinia sp. RSM007
GGGZ	Eigenmannia virescens
GGHA	Ictalurus punctatus
GGHB	Cylindromyia sp. CylindSp011
GGHC	Gymnosoma nitens
GGHD	Eurychaeta muscaria
GGHE	Mesembrinella bellardiana
GGHF	Muscina stabulans
GGHG	Mydaea urbana
GGHH	Ulurumyia macalpinei
GGHI	Apteronotus albifrons
GGHJ	Apteronotus leptorhynchus
GGHK	Parapteronotus hasemani
GGHL	Colossoma macropomum
GGHM	Jasus edwardsii
GGHN	Hebecnema umbratica
GGHO	Mintho rufiventris
GGHP	Mystacinobia zelandica
GGHQ	Phaonia angelicae
GGHR	Polietes lardarius
GGHS	Pseudogonia rufifrons
GGHT	Sarcophaga sp. SarcoSp002
GGHU	Stevenia sp. StevSp012
GGHV	Verticia nigra
GGHW	Penium margaritaceum
GGIA	Adamussium colbecki
GGIC	Saccostrea glomerata
GGID	Racocetra castanea
GGIE	Scutellospora calospora
GGIF	Jatropha curcas
GGII	Funneliformis mosseae
GGIJ	Claroideoglomus claroideum
GGIK	Ambispora leptoticha
GGIL	Paraglomus brasilianum
GGIM	Diversispora versiformis
GGIN	Rhizophagus irregularis
GGIO	Acaulospora morrowiae
GGIP	Crotalus scutulatus
GGIQ	Hirudo verbana
GGIS	Sterculia lanceolata
GGIT	Phenacoccus solenopsis
GGIU	Glycine tomentella
GGIV	Glycine syndetika
GGIW	Glycine dolichocarpa
GGIX	Ixodes scapularis
GGIY	Saccharomyces cerevisiae
GGIZ	Crassostrea angulata
GGJA	Larix laricina
GGJB	Saccharomyces cerevisiae
GGJC	Saccharomyces cerevisiae
GGJD	Nothofagus pumilio
GGJE	Nothofagus pumilio
GGJF	Cobitis taenia
GGJG	Abies balsamea
GGJH	Pinus banksiana
GGJI	Picea glauca
GGJJ	Picea mariana
GGJK	Pinus strobus
GGJL	Thuja occidentalis
GGJM	Lepas anatifera
GGJN	Pollicipes pollicipes
GGJO	Passiflora oerstedii
GGJP	Saccharomyces cerevisiae
GGJQ	Citrus x microcarpa
GGJR	Alveopora japonica
GGJS	Plectus murrayi
GGJT	Scottnema lindsayae
GGJV	Nothofagus pumilio
GGJW	Nothofagus pumilio
GGJX	Arabidopsis thaliana
GGJY	Pieris rapae
GGJZ	Colias eurytheme
GGKA	Medicago sativa
GGKB	Papilio polytes
GGKC	Heliconius cydno
GGKD	Geotrichum candidum
GGKE	Aspidiotus destructor
GGKF	Hydra vulgaris
GGKG	Taxus baccata
GGKH	Hydra vulgaris
GGKI	Ruditapes philippinarum
GGKJ	gut metagenome
GGKK	Sitophilus oryzae
GGKL	Tachypleus tridentatus
GGKM	Trichogramma chilonis
GGKN	Crassostrea hongkongensis
GGKO	Penaeus vannamei
GGKP	Eremochloa ophiuroides
GGKQ	Dendroctonus ponderosae
GGKR	Charybdis japonica
GGKS	Cucurbita pepo subsp. pepo
GGKT	aquatic metagenome
GGKU	aquatic metagenome
GGKV	aquatic metagenome
GGKW	aquatic metagenome
GGKX	aquatic metagenome
GGKY	Isoetes echinospora
GGKZ	Chrysoperla zastrowi sillemi
GGLA	Perna canaliculus
GGLB	Odorrana tormota
GGLC	Agaricia lamarcki
GGLD	Taeniopygia guttata
GGLE	Ornithodoros turicata
GGLF	Nepenthes x hookeriana
GGLG	Nepenthes rafflesiana
GGLH	Penaeus monodon
GGLI	Hemileia vastatrix HvCat
GGLJ	Nepenthes ampullaria
GGLK	Macronectes giganteus
GGLL	Thalassiosira rotula
GGLM	Haematobia irritans
GGLN	Phyllanthus emblica
GGLO	Hormiphora californensis
GGLP	Harmothoe imbricata
GGLQ	Thalassiosira rotula
GGLR	Eleusine multiflora
GGLS	Chloris flagellifera
GGLT	Anemonia viridis
GGLU	Digitaria milanjiana
GGLV	Panchlora nivea
GGLW	Arctia plantaginis
GGLX	Pleurotus ostreatus
GGLY	Eleusine coracana
GGLZ	Eleusine coracana
GGMA	Eleusine coracana subsp. coracana
GGMB	Eleusine coracana subsp. africana
GGMC	Eleusine intermedia
GGMD	Eleusine tristachya
GGME	Eleusine floccifolia
GGMF	Phaius tancarvilleae
GGMG	Euphorbia lathyris
GGMH	Euphorbia lathyris
GGMI	Xenoturbella bocki
GGMJ	Crotalus cerastes
GGMK	Psilocybe cubensis
GGMM	Cedrela balansae
GGMN	Idotea baltica
GGMO	Actinidia chinensis
GGMP	Laguncularia racemosa
GGMQ	Citrus maxima
GGMR	Schizaphis graminum
GGMS	Sipha flava
GGMT	bird metagenome
GGMU	Serangium japonicum
GGMV	Amblema plicata
GGMW	Adoxophyes orana
GGMX	Chelonia mydas
GGMY	Carposina sasakii
GGMZ	Phylliroe bucephala
GGNA	Vampyroteuthis infernalis
GGNB	Octopoteuthis deletron
GGNC	Chiroteuthis calyx
GGND	Pterygioteuthis hoylei
GGNE	Scolopendra viridis
GGNF	Perca fluviatilis
GGNG	Dosidicus gigas
GGNH	Nilaparvata lugens
GGNI	Lepidium meyenii
GGNJ	Hamamelis mollis
GGNK	Astragalus canadensis
GGNL	Galega orientalis
GGNM	Ononis spinosa
GGNN	Glycyrrhiza uralensis
GGNO	Onobrychis viciifolia
GGNP	Oxytropis lambertii
GGNQ	Sphenodon punctatus
GGNR	Octopus vulgaris
GGNS	Rana temporaria
GGNT	Spirostomum semivirescens
GGNU	Spirostomum sp. Valltjaern
GGNV	Leptinotarsa decemlineata
GGNW	Camellia sinensis
GGNX	Semisulcospira coreana
GGNY	Stichodactyla helianthus
GGNZ	Rhipicephalus microplus
GGOA	Caulerpa cylindracea
GGOB	Chrysomela lapponica
GGOC	Rhipicephalus microplus
GGOD	Rhipicephalus microplus
GGOE	Euglena longa
GGOF	Tengella perfuga
GGOG	Rhipicephalus microplus
GGOH	Paratapes undulatus
GGOI	Mylnosiga fluctuans
GGOJ	Salpingoeca helianthica
GGOK	Salpingoeca dolichothecata
GGOL	Savillea parva
GGOM	Stephanoeca diplocostata
GGON	Microstomoeca roanoka
GGOO	Hartaetosiga balthica
GGOP	Choanoeca perplexa
GGOQ	Didymoeca costata
GGOR	Helgoeca nana
GGOS	Stephanoeca diplocostata
GGOT	Salpingoeca macrocollata
GGOU	Hartaetosiga gracilis
GGOV	Codosiga hollandica
GGOW	Salpingoeca infusionum
GGOX	Salpingoeca kvevrii
GGOY	Salpingoeca urceolata
GGOZ	Salpingoeca punica
GGPA	Acanthoeca spectabilis
GGPB	Diaphanoeca grandis
GGPC	Iris domestica
GGPD	Eleusine coracana subsp. africana
GGPE	Eleusine coracana subsp. africana
GGPH	Diceroprocta semicincta
GGPJ	Nezara viridula
GGPK	Homarus americanus
GGPL	Heliothis subflexa
GGPP	Psidium guajava
GGPQ	Panax notoginseng
GGPR	Mirounga leonina
GGPS	Anthurium andraeanum
GGPT	Bubalus bubalis
GGPU	Bubalus bubalis
GGPV	Bubalus bubalis
GGPW	Bubalus bubalis
GGPX	Bubalus bubalis
GGPY	Bubalus bubalis
GGPZ	Bubalus bubalis
GGQA	Bubalus bubalis
GGQB	Bubalus bubalis
GGQC	Bubalus bubalis
GGQD	Bubalus bubalis bubalis
GGQE	Crassostrea virginica
GGQF	Bubalus bubalis
GGQG	Cichorium intybus
GGQH	Quercus pubescens
GGQI	Quercus ilex
GGQJ	Quercus robur
GGQL	Acipenser sturio
GGQM	Cichorium endivia
GGQN	Temora longicornis
GGQO	Eriocheir sinensis
GGQP	Diaphanosoma celebensis
GGQQ	Oratosquilla oratoria
GGQR	Varroa destructor
GGQS	Dermacentor variabilis
GGQT	Eogammarus possjeticus
GGQU	Sepia esculenta
GGQV	Penaeus vannamei
GGQW	Tracheliastes polycolpus
GGQX	Caraiba andreae
GGQY	Cubophis cantherigerus
GGQZ	Tretanorhinus variabilis
GGRA	Berberis thunbergii
GGRB	Lumbricus castaneus
GGRC	Bubalus bubalis
GGRD	Pardosa pseudoannulata
GGRE	Agave sisalana
GGRF	Neonothopanus gardneri
GGRG	Rhyacophila nubila
GGRH	Lampronia capitella
GGRI	Panellus stipticus
GGRJ	Panellus stipticus
GGRK	Lentinula edodes
GGRL	Trichogramma chilonis
GGRM	Panax ginseng
GGRN	Dolomedes triton
GGRO	Daphnia magna
GGRP	Pocillopora acuta
GGRQ	Pocillopora acuta
GGRR	Perna viridis
GGRS	Pocillopora acuta
GGRT	Carya illinoinensis
GGRU	Crangon crangon
GGRV	Lavandula angustifolia
GGRW	Lavandula angustifolia
GGRZ	Spodoptera exigua
GGSA	Corylus avellana
GGSB	Glehnia littoralis
GGSC	Sardina pilchardus
GGSD	Gryllus veletis
GGSE	honeybee metagenome
GGSF	Tectona grandis
GGSI	Aquilaria malaccensis
GGTK	Oxytenanthera abyssinica
GGTL	Mantella betsileo
GGTM	Camellia sinensis
GGTN	Penaeus merguiensis
GGTO	Penaeus vannamei
GGTP	Metapenaeus endeavouri
GGTQ	Metapenaeus ensis
GGTR	Penaeus esculentus
GGTS	Penaeus monodon
GGTT	Penaeus latisulcatus
GGTU	Penaeus longistylus
GGTV	Penaeus semisulcatus
GGTW	Zoanthus sp. QL-2018
GGTX	Caerostris darwini
GGTY	Myosoton aquaticum
GGTZ	Dermacentor variabilis
GGUA	Boiga cynodon
GGUB	Boiga dendrophila
GGUC	Boiga dendrophila
GGUD	Boiga irregularis
GGUE	Boiga irregularis
GGUF	Boiga nigriceps
GGUG	Boiga trigonata
GGUH	Misgurnus anguillicaudatus
GGUI	Palythoa sp. QL-2018
GGUJ	Citrus maxima
GGUK	Penaeus vannamei
GGUL	Nymphaea alba
GGUM	Citrus maxima
GGUN	Goniomonas avonlea
GGUO	Caerostris darwini
GGUP	Kappaphycus alvarezii
GGUQ	Anaxyrus baxteri
GGUR	Anaxyrus baxteri
GGUS	Anaxyrus baxteri
GGUT	Penaeus vannamei
GGUU	Bletilla striata
GGUV	Crassostrea nippona
GGUW	Mytilus galloprovincialis
GGUX	Symphyotrichum ascendens
GGUY	Bos taurus
GGUZ	Bos taurus
GGVA	Bos taurus
GGVB	Bos taurus
GGVC	Bos taurus
GGVD	Bos taurus
GGVE	Bos taurus
GGVF	Bos taurus
GGVG	Bos taurus
GGVH	Bos taurus
GGVI	Bos taurus
GGVJ	Fragilaria radians
GGVK	Metorchis orientalis
GGVL	Bos indicus
GGVM	Loxechinus albus
GGVN	Micropterus salmoides
GGVO	Rotylenchulus reniformis
GGVP	Rotylenchulus reniformis
GGVQ	Rotylenchulus reniformis
GGVR	Rotylenchulus reniformis
GGVS	Haliotis fulgens
GGVT	Plantago major
GGVU	Amphiura filiformis
GGVV	Rotylenchulus reniformis
GGVW	Rapana venosa
GGVZ	Acetes chinensis
GGWA	Citrus maxima
GGWB	Amoebophrya sp. ex Karlodinium veneficum
GGWD	Haemoproteus columbae
GGWE	Tripedalia cystophora
GGWF	Rhodococcus rhodochrous
GGWG	Amoebophrya sp. ex Karlodinium veneficum
GGWH	Phacoides pectinatus
GGWI	Daphnia magna
GGWJ	Acipenser oxyrinchus
GGWK	Acipenser gueldenstaedtii
GGWM	Rhizopus stolonifer
GGWN	Anaeromyces contortus
GGWO	Anaeromyces contortus
GGWP	Anaeromyces contortus
GGWQ	Anaeromyces contortus
GGWR	Anaeromyces contortus
GGWS	Caecomyces sp. Brit4
GGWT	Feramyces austinii
GGWU	Feramyces austinii
GGWV	Orpinomyces sp. D3A
GGWW	Orpinomyces sp. D3B
GGWX	Orpinomyces sp. D4C
GGWY	Piromyces sp. S4B
GGWZ	Piromyces sp. FX4B
GGXA	Piromyces sp. YC3
GGXB	Piromyces sp. A1
GGXC	Neocallimastix sp. G3
GGXD	Fusarium acuminatum
GGXE	Caecomyces sp. Iso3
GGXF	Piromyces sp. FS3c
GGXG	Piromyces sp. A2
GGXH	Piromyces sp. B4
GGXI	Piromyces sp. B5
GGXJ	Neocallimastix frontalis
GGXK	Pygoscelis papua
GGXL	Pygoscelis antarcticus
GGXM	Garcinia mangostana
GGXN	Neocaridina denticulata
GGXO	Ceanothus thyrsiflorus
GGXP	Protopterus annectens
GGXQ	Octopus maya
GGXR	Datisca glomerata
GGXS	Plectranthus amboinicus
GGXT	Smilax myosotiflora
GGXU	Strobilanthes crispa
GGXV	Pteris vittata
GGXW	Daphnia galeata
GGXX	Chara braunii
GGXY	Rhipicephalus microplus
GGXZ	Platanus x hispanica
GGYA	Salisapilia sapeloensis
GGYB	Trematomus bernacchii
GGYC	Trematomus bernacchii
GGYD	Vanda hybrid cultivar
GGYE	Gynura procumbens
GGYF	Acipenser sinensis
GGYG	Sinella curviseta
GGYH	Eucheuma denticulatum
GGYJ	Vanda hybrid cultivar
GGYK	Vanda hybrid cultivar
GGYL	Vanda hybrid cultivar
GGYM	x Vandachostylis hybrid cultivar
GGYN	Skeletonema marinoi
GGYO	Hypothenemus hampei
GGYP	Aceria tosichella
GGYQ	Pocillopora acuta
GGYR	Pocillopora acuta
GGYS	Pocillopora acuta
GGYT	Trematomus bernacchii
GGYU	Trematomus bernacchii
GGYV	Trematomus bernacchii
GGYW	Trematomus bernacchii
GGYX	Trematomus bernacchii
GGYY	Trematomus bernacchii
GGYZ	Trematomus bernacchii
GGZA	Trematomus bernacchii
GGZB	Trematomus bernacchii
GGZC	Trematomus bernacchii
GGZD	Trematomus bernacchii
GGZE	Trematomus bernacchii
GGZF	Trematomus bernacchii
GGZG	Trematomus bernacchii
GGZH	Trematomus bernacchii
GGZI	Trematomus bernacchii
GGZJ	Trematomus bernacchii
GGZK	Trematomus bernacchii
GGZL	Saccostrea glomerata
GGZM	Saccostrea sp. non-mordax lineage J
GGZN	Cairina moschata
GGZO	Pelargonium radula
GGZP	Lupinus angustifolius
GGZQ	Plectranthus aromaticus
GGZR	Cycas sphaerica
GGZS	Cycas sphaerica
GGZT	Acipenser oxyrinchus
GGZU	Salmon gill poxvirus
GGZV	Zingiber officinale
GGZW	Zingiber officinale
GGZX	Acipenser oxyrinchus
GGZY	Justicia gendarussa
GGZZ	Rhopilema esculentum
GHAA	Justicia gendarussa
GHAB	Dicyema japonicum
GHAC	Piper methysticum
GHAD	Bradybaena similaris
GHAE	Mytilus edulis
GHAF	Morbakka virulenta
GHAG	Aurelia aurita
GHAH	Anguilla anguilla
GHAI	Aurelia aurita
GHAJ	Apocyclops royi
GHAK	Aurelia aurita
GHAL	Physella acuta
GHAM	Chaetoceros affinis
GHAN	Chaetoceros affinis
GHAO	Metabetaeus minutus
GHAP	Metabetaeus lohena
GHAQ	Tripedalia cystophora
GHAR	Nemopilema nomurai
GHAS	Aurelia aurita complex sp. Pacific
GHAT	Crassostrea gigas
GHAU	Pecten maximus
GHAV	Ruditapes philippinarum
GHAW	Clavularia sp.
GHAX	Chironex yamaguchii
GHAY	Etmopterus spinax
GHAZ	Velella velella
GHBA	Porpita porpita
GHBB	Physalia physalis
GHBC	Xenia sp. KK-2018
GHBD	Briareum asbestinum
GHBE	Caridina rubella
GHBF	Haliotis tuberculata
GHBG	Copula sivickisi
GHBH	Pelobates cultripes
GHBI	Halocaridinides trigonophthalma
GHBJ	Antecaridina lauensis
GHBK	Halocaridina rubra
GHBL	Semibalanus balanoides
GHBM	Medicago truncatula
GHBN	Helianthus tuberosus
GHBO	Scaphiopus couchii
GHBP	Henneguya salminicola
GHBQ	Sillago sihama
GHBR	Myxobolus squamalis
GHBS	Plasmodium falciparum
GHBT	Octopus maya
GHBU	Micromonas polaris
GHBV	Martes zibellina
GHBW	Odontella aurita
GHBX	Nitzschia palea
GHBY	Hemiscolopendra marginata
GHBZ	Scolopocryptops sexspinosus
GHCA	Beckmannia syzigachne
GHCB	Vriesea carinata
GHCC	Dalbulus maidis
GHCD	Anemonia viridis
GHCE	Pyricularia oryzae
GHCF	Pyricularia oryzae
GHCG	Rhinella arenarum
GHCH	Apostichopus japonicus
GHCK	Paris polyphylla var. yunnanensis
GHCL	Eupentacta fraudatrix
GHCM	Gasterosteus aculeatus
GHCN	Gammarus wautieri
GHCO	Gammarus pulex
GHCP	Gammarus pulex
GHCQ	Gammarus pulex
GHCR	Gammarus wautieri
GHCS	Gammarus pulex
GHCT	Echinogammarus berilloni
GHCU	Echinogammarus berilloni
GHCV	Marinogammarus marinus
GHCW	Marinogammarus marinus
GHCX	Gammarus fossarum
GHCY	Gammarus fossarum
GHCZ	Gammarus fossarum
GHDA	Gammarus fossarum
GHDB	Gammarus fossarum
GHDC	Gammarus fossarum
GHDD	Desmophyllum pertusum
GHDE	Podosphaera pannosa
GHDF	Phloeomyzus passerinii
GHDG	Dunaliella salina
GHDH	Malpighia emarginata
GHDI	Apostichopus japonicus
GHDJ	Metapenaeus bennettae
GHDK	Laupala cerasina
GHDL	Paraescarpia echinospica
GHDM	Paraescarpia echinospica
GHDN	Hypsignathus monstrosus
GHDO	Rousettus aegyptiacus
GHDP	Larimichthys crocea
GHDQ	Macrobrachium tolmerum
GHDR	Oratosquilla oratoria
GHDS	Thuja koraiensis
GHDT	Macrobrachium australiense
GHDU	Macrobrachium koombooloomba
GHDV	Raffaelea quercus-mongolicae
GHDW	Macrobrachium novaehollandiae
GHDX	Echinochloa colona
GHDY	Taraxacum coreanum
GHDZ	Batrachuperus yenyuanensis
GHEA	Pleurotus djamor
GHEB	Undaria pinnatifida
GHEC	Erysiphe pisi
GHED	Saccharina japonica
GHEE	Tokudaia osimensis
GHEF	Podosphaera xanthii
GHEG	Haemulon carbonarium
GHEH	Thermobia domestica
GHEI	sponge metagenome
GHEJ	Davidia involucrata
GHEK	Entodinium caudatum
GHEL	Camellia sinensis
GHEM	Prototheca zopfii
GHEN	Paralichthys olivaceus
GHEO	Davidia involucrata
GHEP	Davidia involucrata
GHEQ	Davidia involucrata
GHER	Davidia involucrata
GHES	Davidia involucrata
GHET	Davidia involucrata
GHEU	Coenosia sp. anthr013
GHEV	Boehmeria nivea
GHEW	Dryopteris erythrosora
GHEX	Pollenia sp. poln016
GHEY	Gymnoprosopa sp. milt015
GHEZ	Fannia canicularis
GHFA	Scathophaga stercoraria
GHFB	Bathyplectes anurus
GHFC	Neolepas marisindica
GHFE	Schoenomyza sp. heca017
GHFF	Cordilura sp. cordr014
GCUV	Chlorella sorokiniana
GCUX	Chrysura radians
GCUY	Chrysura cuprea
GCVB	Brachyserphus parvulus
GCVC	Allodynerus rossii
GCVD	Clusia lateralis
GCVE	Suaeda fruticosa
GCVF	Thalassiosira rotula
GCVG	Macrobrachium nipponense
GCVH	Conus lenavati
GCVI	Palythoa variabilis
GCVM	Conus tribblei
GCVN	Citrus trifoliata
GCVO	Pardosa pseudoannulata
GCVP	Zymoseptoria brevis
GCVQ	Pimephales promelas
GCVR	Senna alexandrina
GCVS	Pardosa pseudoannulata
GCVT	Pardosa pseudoannulata
GCVU	Chrysomphalus aonidum
GCVV	Empoasca fabae
GCVW	Nabicula subcoleoptrata
GCVX	Epiphyas postvittana
GCVY	Penaeus vannamei
GCVZ	Alydus pilosus
GCWA	Aphelonotus fraterculus
GCWB	Columbicola columbae
GCWC	Boisea trivittata
GCWD	Campanulotes compar
GCWE	Arilus cristatus
GCWF	Bruchomorpha oculata
GCWG	Anasa tristis
GCWH	Hoplitocoris sp. AD-2014
GCWI	Enchenopa latipes
GCWJ	Lachesilla contraforcepeta
GCWK	Belostoma flumineum
GCWL	Piezosternum calidum
GCWM	Geocoris sp. AD-2014
GCWN	Craspedorrhynchus sp. AD-2014
GCWO	Aphalara polygoni
GCWP	Dalbulus maidis
GCWQ	Cyrpoptus belfragei
GCWR	Acrosternum hilare
GCWS	Ceratocombus sp. AD-2014
GCWT	Agallia constricta
GCWU	Aclerda sp. AD-2014
GCWV	Dactylopius confusus
GCWW	Coccus sp. AD-2014
GCWX	Llanquihuea pilosa
GCWY	Echmepteryx hageni
GCWZ	Ceroplastes cirripediformis
GCXA	Corimelaena lateralis
GCXB	Heteropsylla cubana
GCXC	Acanalonia conica
GCXD	Geomydoecus ewingi
GCXE	Buenoa margaritacea
GCXF	Lopidea amorphae
GCXG	Hespenedra chilensis
GCXH	Ischnodemus falicus
GCXI	Gelastocoris oculatus
GCXJ	Acutaspis umbonifera
GCXK	Chauliops fallax
GCXL	Jalysus sp. AD-2014
GCXM	Lygus lineolaris
GCXN	Mapuchea sp. AD-2014
GCXO	Ladella sp. AD-2014
GCXQ	Macrohomotoma gladiata
GCXR	Largus californicus
GCXS	Mesovelia mulsanti
GCXT	Orothrips kelloggi
GCXU	Pagasa sp. AD-2014
GCXV	Megacopta cribraria
GCXW	Holdgatiella chepuensis
GCXX	Largus californicus
GCXY	Oncopeltus fasciatus
GCXZ	Idiosystatus acutiusculus
GCYA	Limnoporus canaliculatus
GCYB	Lygaeus turcicus
GCYC	Pachypsylla celtidismamma
GCYD	Ptycta johnsoni
GCYE	Scutelleridae sp. AD-2014
GCYF	Nessorhinus gibberulus
GCYG	Chondrodire chilensis
GCYH	Phylloscelis atra
GCYI	Phymata pennsylvanica
GCYJ	Prosapia bicincta
GCYK	Reuteroscopus ornatus
GCYL	Orius insidiosus
GCYM	Mezira granulata
GCYN	Anoplogonius nigricollis
GCYP	Rhagovelia obesa
GCYQ	Phlaeothripidae sp. AD-2014
GCYR	Frankliniella occidentalis
GCYS	Chalcocoris rutilans
GCYT	Trionymus caricis
GCYV	Megatibicen dorsatus
GCYW	Psyllopsis fraxinicola
GCYX	Trioza urticae
GCYY	Tuberolachnus salignus
GCYZ	Trichocorixa calva
GCZA	Philaenus spumarius
GCZB	Sehirus cinctus
GCZC	Uroleucon ambrosiae
GCZD	Vidanoana flavomaculata
GCZE	Melanoliarus placitus
GCZF	Ponana quadralaba
GCZG	Peloridium pomponorum
GCZH	Prociphilus tessellatus
GCZI	Schizaphis graminum
GCZJ	Unaspis euonymi
GCZK	Stictocephala bisonia
GCZL	Nicotiana attenuata
GCZM	Cycadothrips chadwicki
GCZN	Abies pinsapo
GCZO	Picea glauca
GCZP	Bryum argenteum var. argenteum
GCZQ	Poa infirma
GCZR	Poa supina
GCZS	Paracentrotus lividus
GCZT	Aedes albopictus
GCZU	Sinningia speciosa
GCZV	Senna alexandrina
GCZW	Bemisia tabaci
GCZX	Saccharum hybrid cultivar
GCZY	Poa annua
GCZZ	Schmidtea mediterranea
GDAA	insect metagenome
GDAB	Gentiana rigescens
GDAC	Euprymna scolopes
GDAD	Pseudonaja textilis
GDAE	Haementeria vizottoi
GDAF	Perinereis aibuhitensis
GDAG	Schmidtea mediterranea
GDAH	Ammopiptanthus mongolicus
GDAI	Tabanus bromius
GDAJ	Euphrynichus bacillifer
GDAK	Chelifer cancroides
GDAL	Echiniscus testudo
GDAM	Halicryptus spinulosus
GDAN	Pycnophyes kielensis
GDAO	Phalangium opilio
GDAP	Gluvia dorsalis
GDAQ	Mastigoproctus giganteus
GDAR	Dendroctonus ponderosae
GDAS	Haliotis discus hannai
GDAT	Lolium perenne
GDAU	Isatis tinctoria
GDAV	Musca domestica
GDAW	Lygus lineolaris
GDAX	Carya cathayensis
GDAY	Agkistrodon contortrix contortrix
GDAZ	Agkistrodon piscivorus conanti
GDBA	Boiga irregularis
GDBB	Crotalus adamanteus
GDBC	Crotalus horridus
GDBD	Crotalus horridus
GDBE	Hypsiglena sp. JMG-2014
GDBF	Micrurus fulvius
GDBG	Streblospio benedicti
GDBH	Micrurus tener
GDBI	Sistrurus tergeminus
GDBJ	Sistrurus miliarius barbouri
GDBK	Arachis stenosperma
GDBL	Gerbera hybrid cultivar
GDBM	Synchytrium endobioticum
GDBN	Brachyptera vera
GDBO	Incisitermes marginipennis
GDBP	Protonemura ausonia
GDBQ	Comicus calcaris
GDBR	Phaeophilacris bredoides
GDBS	Ergaula capucina
GDBT	Stagmatoptera biocellata
GDBU	Trachyaretaon brueckneri
GDBV	Mantophasma sp. AD-2014
GDBW	Tropidacris collaris
GDBX	Rhagadochir virgo
GDBY	Ptilocerembia catherinae
GDBZ	Apteroperla tikumana
GDCA	Catara rugosicollis
GDCB	Proreus simulans
GDCC	Sipyloidea biplagiata
GDCD	Diapherodes gigantea
GDCE	Agamemnon cornutus
GDCF	Aularches miliaris
GDCG	Symploce sp. AD-2014
GDCH	Phyllocrania paradoxa
GDCI	Nauphoeta cinerea
GDCJ	Sundablatta sexpunctata
GDCK	Antipaluria urichi
GDCL	Brunneria borealis
GDCN	Lymantria dispar
GDCO	Halyomorpha halys
GDCQ	Nemoura sp. AD-2014
GDCR	Blattella germanica
GDCS	Diplatys sp. AD-2014
GDCT	Creoxylus spinosus
GDCU	Hemimerus sp. AD-2014
GDCV	Amphiprion bicinctus
GDCY	endophyte metagenome
GDDC	Leptocera erythrocera
GDDE	Stilpon pauciseta
GDDH	Braula coeca
GDDL	Sebastes caurinus
GDDM	Lymantria dispar
GDDN	Arachis hypogaea
GDDO	Lithobates catesbeianus
GDDQ	Matsumuraiella radiopicta
GDDR	Corixa punctata
GDDS	Stimulopalpus japonicus
GDDT	Mesopsocus unipunctatus
GDDU	Peripsocus phaeopterus
GDDV	Tropaeolum majus
GDDW	Corythucha ciliata
GDDX	Amphipsocus japonicus
GDDY	Graphopsocus cruciatus
GDDZ	Hemipsocus chloroticus
GDEA	Cerobasis guestfalica
GDEB	Daktulosphaira vitifoliae
GDEC	Ischnoptera deropeltiformis
GDED	Diplonychus rusticus
GDEE	Mecopoda elongata
GDEF	Graphocephala fennahi
GDEG	Hydrometra stagnorum
GDEH	Notonecta glauca
GDEI	Haematomyzus elephantis
GDEJ	Echinophthirius horridus
GDEK	Cimex lectularius
GDEL	Lachesilla abiesicola
GDEM	Xenophyes metoponcus
GDEN	Aphrophora alni
GDEO	Ulopa reticulata
GDEP	Dictyophara europaea
GDEQ	Aphelocheirus aestivalis
GDER	Saldula saltatoria
GDES	Plea minutissima
GDET	Bertkauia sp. AD-2014
GDEU	Heterocaecilius solocipennis
GDEV	Longivalvus nubilus
GDEW	Ilyocoris cimicoides
GDEX	Tachycixius pilosus
GDEY	Aaroniella sp. AD-2014
GDEZ	Arocatus melanocephalus
GDFA	Metatropis rufescens
GDFB	Valenzuela badiostigma
GDFC	Neoblaste papillosa
GDFD	Aradus betulae
GDFE	Caliscelis bonellii
GDFF	Centrotus cornutus
GDFG	Badonnelia titei
GDFH	Metcalfa pruinosa
GDFI	Pyrrhocoris apterus
GDFJ	Lygaeus equestris
GDFK	Embidopsocus sp. AD-2014
GDFL	Elipsocus kuriliensis
GDFM	Franklinothrips vespiformis
GDFN	Diaphorina citri
GDFO	Aquarius paludum
GDFP	Glycaspis brimblecombei
GDFQ	Brassica napus
GDFR	Austrofundulus limnaeus
GDFS	Polistes fuscatus
GDFT	Nypa fruticans
GDFU	Hevea brasiliensis
GDFV	Neomysis awatschensis
GDFW	Tigriopus kingsejongensis
GDFX	Corollospora maritima
GDFY	Aethionema arabicum
GDFZ	Cleome violacea
GDGA	Capparis spinosa
GDGB	Koeberlinia spinosa
GDGC	Batis maritima
GDGD	Gyrostemon ramulosus
GDGE	Reseda odorata
GDGF	Limnanthes douglasii
GDGG	Akania bidwillii
GDGH	Zenia insignis
GDGI	Aethionema arabicum
GDGJ	Pentadiplandra brazzeana
GDGK	Emblingia calceoliflora
GDGL	Moringa oleifera
GDGM	Ptychodera flava
GDGN	Amyelois transitella
GDGO	Austrofundulus limnaeus
GDGP	Oryzias melastigma
GDGQ	Austrofundulus limnaeus
GDGR	Austrofundulus limnaeus
GDGS	Austrofundulus limnaeus
GDGT	Austrofundulus limnaeus
GDGU	Nicotiana tabacum
GDGV	Austrofundulus limnaeus
GDGW	Austrofundulus limnaeus
GDGX	Austrofundulus limnaeus
GDGY	Austrofundulus limnaeus
GDGZ	Austrofundulus limnaeus
GDHA	Austrofundulus limnaeus
GDHB	Hevea brasiliensis
GDHC	Lygus hesperus
GDHD	Cymbidium faberi
GDHE	Phalaenopsis equestris
GDHF	Bactrocera latifrons
GDHG	Austrofundulus limnaeus
GDHH	Austrofundulus limnaeus
GDHI	Austrofundulus limnaeus
GDHJ	Phalaenopsis equestris
GDHK	Equus caballus
GDHM	Phalaenopsis equestris
GDHO	Phalaenopsis equestris
GDHP	Austrofundulus limnaeus
GDHQ	Polistes metricus
GDHR	Luffa aegyptiaca
GDHS	Austrofundulus limnaeus
GDHT	Austrofundulus limnaeus
GDHU	Austrofundulus limnaeus
GDHV	Austrofundulus limnaeus
GDHW	Austrofundulus limnaeus
GDHX	Austrofundulus limnaeus
GDHY	Austrofundulus limnaeus
GDHZ	Austrofundulus limnaeus
GDIA	Rapana venosa
GDIB	Austrofundulus limnaeus
GDIC	Ornithodoros turicata
GDID	Trepomonas sp. PC1
GDIE	Ornithodoros turicata
GDIF	Acropora hyacinthus
GDIG	Trichosanthes kirilowii
GDIH	Austrofundulus limnaeus
GDII	Austrofundulus limnaeus
GDIJ	Silene conica
GDIK	Pseudocercospora eumusae
GDIL	Cucumis sativus
GDIM	Stomoxys calcitrans
GDIN	Pseudocercospora musae
GDIO	Locusta migratoria manilensis
GDIP	Daphnia magna
GDIQ	Daphnia magna
GDIR	Silene conica
GDIS	Silene conica
GDIT	Silene conica
GDIU	Austrofundulus limnaeus
GDIV	Silene conica
GDIW	Silene conica
GDIX	Silene conica
GDIY	Silene conica
GDIZ	Silene conica
GDJA	Silene conica
GDJB	Silene conica
GDJC	Silene conica
GDJD	Silene conica
GDJE	Silene conica
GDJF	Silene conica
GDJG	Silene conica
GDJH	Silene conica
GDJI	Silene conica
GDJJ	Silene conica
GDJK	Silene conica
GDJL	Silene macrodonta
GDJM	Cotesia rubecula
GDJN	Ascochyta rabiei
GDJO	Cotesia glomerata
GDJP	Cotesia rubecula bracovirus
GDJQ	Cotesia glomerata bracovirus
GDJR	Euglena gracilis
GDJS	Bubalus bubalis
GDJT	Pisum sativum
GDJU	Pisum sativum
GDJV	Pisum sativum
GDJW	Pisum sativum
GDJX	Anthurium amnicola
GDJY	Lingula anatina
GDJZ	Pisum sativum
GDKA	Rhynchophorus ferrugineus
GDKB	Cydia pomonella
GDKC	Ficus carica
GDKD	Cuscuta reflexa
GDKE	Cuscuta gronovii
GDKF	Auxenochlorella protothecoides
GDKG	Bixa orellana
GDKH	Voromonas pontica
GDKI	Alphamonas edax
GDKJ	Colpodella angusta
GDKK	Colpodella angusta
GDKL	Salvia pomifera
GDKM	Oryza sativa Indica Group
GDKN	Arachis hypogaea
GDKO	Marmota monax
GDKP	Oncorhynchus mykiss
GDKQ	Nicrophorus vespilloides
GDKR	Trichobilharzia regenti
GDKS	Anopheles sinensis
GDKT	Vigna unguiculata subsp. sesquipedalis
GDKU	Thamnophis sirtalis
GDKV	Pseudagkistrodon rudis
GDKW	Rhodnius neglectus
GDKX	Choanocystis sp. FB-2015
GDKY	Asellus aquaticus
GDLA	Larinus minutus
GDLB	Melinopterus prodromus
GDLD	Pharaxonotha floridana
GDLE	Mimemodes sp. AD-2015
GDLF	Calosoma frigidum
GDLG	Byturus ochraceus
GDLH	Cybister lateralimarginalis
GDLI	Hypocaccus fitchi
GDLJ	Anorus arizonicus
GDLL	Pentodon sp. AD-2015
GDLM	Porrostoma sp. AD-2015
GDLN	Trox sp. AD-2015
GDLO	Inopeplus dimidiatus
GDLP	Paragymnomerus spiricornis
GDLQ	Mystrophorus formicaeformis
GDLS	Hypothenemus hampei
GDLT	Tectona grandis
GDLV	Crocinae sp. AD-2015
GDMA	Neomida bicornis
GDMB	Litargus sp. AD-2015
GDMC	Metacerylon minutum
GDMD	Anthocomus equestris
GDME	Biphyllus sp. AD-2015
GDMG	Ptilinus pectinicornis
GDMH	Cicindela hybrida
GDMI	Byrrhus pilula
GDMJ	Hydroscapha redfordi
GDML	Anoplotrupes stercorosus
GDMM	Cis boleti
GDMN	Rigidoporus microporus
GDMO	Scraptia sp. AD-2015
GDMP	Macrohyliota militaris
GDMQ	Sitophilus zeamais
GDMR	Mordella sp. AD-2015
GDMS	Odontotaenius disjunctus
GDMT	Spercheus emarginatus
GDMU	Serangium maculigerum
GDMV	Donacia marginata
GDMW	Haliplus fluviatilis
GDMX	Atomaria fuscata
GDMY	Dryops sp. AD-2015
GDNA	Noterus clavicornis
GDNB	Dineutus sp. AD-2015
GDNC	Anteon gaullei
GDND	Colpopyga flavipes
GDNE	Onthophagus similis
GDNF	Euparius marmoreus
GDNG	Trochalus sp. AD-2015
GDNH	Sinaspidytes wrasei
GDNI	Camenta innocua
GDNJ	Heterochelus sp. AD-2015
GDNK	Carpophilus melanopterus
GDNL	Diaprepes abbreviatus
GDNM	Xylobiops basilaris
GDNN	Pempsamacra sp. AD-2015
GDNO	Hybosorus sp. AD-2015
GDNP	Curculio sp. AD-2015
GDNQ	Eulasia bombylius
GDNR	Oxoplatypus quadridentatus
GDNS	Orchesia sp. AD-2015
GDNT	Adoretus sp. AD-2015
GDNV	Glaresis sp. AD-2015
GDNW	Cucujus clavipes
GDNY	Anomala sp. AD-2015
GDNZ	Neandra brunnea
GDOA	Astenopholis sp. AD-2015
GDOB	Macratria sp. AD-2015
GDOC	Agrilus planipennis
GDOD	Cetonia aurata pisana
GDOE	Agnesiotis pilosula
GDOF	Alurnus ornatus
GDOG	Bitoma cylindrica
GDOJ	Elateroides flabellicornis
GDOK	Oedemera nobilis
GDOL	Oiceoptoma thoracicum
GDOM	Trixagus carinifrons
GDON	Nedyus quadrimaculatus
GDOO	Uleiota planata
GDOP	Melittomma sp. AD-2015
GDOQ	Micromalthus debilis
GDOR	Clambus nigriclavis
GDOS	Laricobius nigrinus
GDOT	Aromia moschata
GDOU	Heterocerus fenestratus
GDOV	Melanotus villosus
GDOW	Harmonia axyridis
GDOX	Ocypus brunnipes
GDOY	Sinodendron cylindricum
GDOZ	Lamprohiza splendidula
GDPA	Helophorus nanus
GDPB	Rhagonycha fulva
GDPC	Thanasimus formicarius
GDPD	Drilus concolor
GDPE	Hydrochus megaphallus
GDPF	Megasternum obscurum
GDPG	Hallomenus binotatus
GDPH	Microcara testacea
GDPI	Elaphrus aureus
GDPJ	Serica brunnea
GDPK	Rhamnusium bicolor
GDPL	Oreina cacaliae
GDPM	Acrotrichis sp. AD-2015
GDPN	Hydraena subimpressa
GDPO	Ips typographus
GDPP	Ptosima undecimmaculata
GDPQ	Lagria hirta
GDPR	Hydrochara caraboides
GDPS	Clinidium baldufi
GDPT	Lilioceris merdigera
GDPU	Macrosiagon limbatum
GDPV	Arrhenodes minutus
GDPW	Pycnomerus sp. AD-2015
GDPY	Lymexylon navale
GDPZ	Placonotus sp. AD-2015
GDQA	Sandalus niger
GDQB	Notolioon sp. AD-2015
GDQC	Stethorus sp. AD-2015
GDQD	Pinus monticola
GDQE	Pinus flexilis
GDQF	Erigeron breviscapus
GDQG	Oncorhynchus kisutch
GDQH	Danio rerio
GDQI	Casuarina equisetifolia
GDQJ	Mesocricetus auratus
GDQK	Casuarina equisetifolia
GDQL	Casuarina equisetifolia
GDQM	Casuarina equisetifolia
GDQN	Pectinophora gossypiella
GDQO	Aethionema carneum
GDQP	Aegypius monachus
GDQQ	Danio rerio
GDQR	Pinus albicaulis
GDQS	Clarias magur
GDQT	Clarias magur
GDQU	Micropterus dolomieu
GDQV	Arachnocampa luminosa
GDQW	Panax ginseng
GDQX	Chanos chanos
GDQY	Schistosoma mansoni
GDQZ	Amauroascus mutatus
GDRA	Amauroascus niger
GDRB	Byssoonygena ceratinophila
GDRC	Chrysosporium queenslandicum
GDRD	Rotaria socialis
GDRE	Rotaria magnacalcarata
GDRF	Ophiophagus hannah
GDRG	Physarum polycephalum
GDRH	Rotaria sordida
GDRI	Aethionema grandiflorum
GDRJ	Rorida droserifolia
GDRK	Rotaria tardigrada
GDRL	Bufotes viridis
GDRM	Limacina antarctica
GDRN	Scylla olivacea
GDRO	Clarias magur
GDRP	Bactrocera dorsalis
GDRS	Stenopsychodes sp. AD-2015
GDRV	Palaeagapetus nearcticus
GDRW	Priapulus caudatus
GDRX	Moriera spinosa
GDRY	Contacyphon laevipennis
GDRZ	Leucaena leucocephala
GDSA	Leucaena leucocephala
GDSC	Psychomyia flavida
GDSG	Nectopsyche candida
GDSM	Helicopsyche borealis
GDTB	Plectrocnemia sp. AD-2015
GDTC	Ptilostomis semifasciata
GDTJ	Triticum aestivum
GDTK	Penaeus vannamei
GDTL	Pisum sativum
GDTM	Pisum sativum
GDTQ	Bacillus rossius
GDTS	Pielomastax soochowensis
GDTT	Haplotropis brunneriana
GDTV	Galloisiana sinensis
GDUD	Phaneroptera falcata
GDUF	Arctopsyche palpata
GDUG	Coptotermes sp. AD-2015
GDUH	insect metagenome
GDUI	Schistosoma mansoni
GDUJ	Talitrus saltator
GDUK	Rhizopus oryzae
GDUL	Olea europaea
GDUN	Aedes aegypti
GDUO	Mantoida sp. AD-2015
GDUS	Heteropteryx dilatata
GDUU	insect gut metagenome
GDUV	Penaeus vannamei
GDUW	Pachyphasma brandbergense
GDUY	Grylloblattina djakonovi
GDVA	Reticulitermes santonensis
GDVD	Eurycantha calcarata
GDVE	Neonetus sp. AD-2015
GDVF	Achrioptera fallax
GDVG	Clitarchus hookeri
GDVH	Hemiandrus sp. AD-2015
GDVJ	Neohirasea fruhstorferi
GDVK	Hemideina thoracica
GDVL	Spinotectarchus acornutus
GDVN	Acheta domesticus
GDVQ	Therea bernhardti
GDVR	Monistria consobrina
GDVS	Propsednura eyrei
GDVT	Poekilocerus pictus
GDVU	Tyrannophasma gladiator
GDVV	Omura congrua
GDVW	Parapetasia femorata
GDVX	Stenopelmatus sp. AD-2015
GDVZ	Myrmecophilus sp. AD-2015
GDWB	Zubovskya sp. AD-2015
GDWC	Xya japonica
GDWD	Grylloblattella sp. AD-2015
GDWG	Cyphoderris sp. AD-2015
GDWI	Galloisiana nipponensis
GDWJ	Polyphaga aegyptiaca
GDWL	Orxines xiphias
GDWM	Oreophoetes peruana
GDWN	Megacrania phelaus
GDWQ	Panchlora nivea
GDWT	Methana parva
GDWU	Supella longipalpa
GDWV	Tryonicus parvus
GDWW	Asiablatta kyotensis
GDWZ	Abrosoma johorense
GDXB	Carausius morosus
GDXC	Pseudophasma velutinum
GDXD	Phymateus viridipes
GDXF	Libethra strigiventris
GDXG	Princisia vanwaerebeki
GDXL	Epidares nolimetangere
GDXM	Metriophasma diocles
GDXN	Zonocerus variegatus
GDXP	Shelfordella lateralis
GDXR	Ramulus artemis
GDXT	Monistria discrepans
GDXV	Dictyophorus griseus
GDXW	Striatophasma naukluftense
GDXX	Stenoscepa sp. AD-2015
GDYB	Nocticola sp. AD-2015
GDYC	Episymploce sundaica
GDYD	Tivia sp. AD-2015
GDYE	Ellipsidion sp. AD-2015
GDYG	Diploptera punctata
GDYH	Spathomorpha lancettifer
GDYI	Paranisacantha sp. AD-2015
GDYJ	Balta vilis
GDYK	Loboptera decipiens
GDYL	Austrophasmatidae sp. AD-2015
GDYM	Systella rafflesii
GDYN	Anostostoma australasiae
GDYP	Ectobius sylvestris
GDYR	Antongilia madagassa
GDYS	Eurycotis floridana
GDYW	Austrophasmatidae sp. AD-2015
GDYX	Atractomorpha sp. AD-2015
GDYY	Agathemera crassa
GDYZ	Dictyophorus spumans
GDZB	Zonocerus elegans
GDZD	Cariblatta sp. AD-2015
GDZE	Nyctibora sp. AD-2015
GDZF	Eucorydia yasumatsui
GDZG	Psedna nana
GDZH	Deropeltis erythrocephala
GDZI	Paratemnopteryx couloniana
GDZJ	Gyna lurida
GDZM	Extatosoma tiaratum
GDZN	Orestes mouhotii
GDZO	Dimorphodes sp. AD-2015
GDZP	Xenophasmina simile
GDZR	Medauroidea extradentata
GDZT	Mantophasma sp. AD-2015
GDZU	Dipsastraea lizardensis
GDZV	Ctenactis echinata
GDZW	Solanum chacoense
GDZX	Solanum chacoense
GDZY	Euthlastoblatta diaphana
GDZZ	Lobopterella dimidiatipes
GEAA	Anallacta methanoides
GEAB	Psammomys obesus
GEAC	Gevuina avellana
GEAD	Pseudosermyle phalangiphora
GEAE	Labeo catla
GEAF	Palpares libelluloides
GEAH	Chrysis phryne
GEAI	Cleptes semiauratus
GEAJ	Xenos vesparum
GEAK	Hedychridium monochroum
GEAM	Cleptes semiauratus
GEAN	Eurytemora affinis
GEAP	Glyphomerus stigma
GEAQ	Podagrionini sp. AD-2015
GEAT	Hedychridium monochroum
GEAU	Haliotis tuberculata
GEAW	Parvoraphidia microstigma
GEAX	Leucoptera coffeella
GEAY	Hyposmocoma kahamanoa
GEAZ	Craterostigmus tasmanianus
GEBA	Palpares libelluloides
GEBC	Parvoraphidia microstigma
GEBD	Chrysis phryne
GEBE	Rutilus rutilus
GEBF	Heterocephalus glaber
GEBG	Homarus americanus
GEBH	Poa pratensis
GEBI	Xenos vesparum
GEBJ	Casuarina equisetifolia
GEBK	Ambystoma mexicanum
GEBL	Heliothis virescens
GEBM	Trichinella nativa
GEBN	Trichinella spiralis
GEBO	Trichinella britovi
GEBP	Trichinella pseudospiralis
GEBQ	Graphocephala atropunctata
GEBR	Trichinella pseudospiralis
GEBS	Trichinella pseudospiralis
GEBT	Trichinella nelsoni
GEBU	Trichinella sp. T6
GEBV	Trichinella murrelli
GEBW	Trichinella papuae
GEBX	Trichinella zimbabwensis
GEBY	Trichinella sp. T8
GEBZ	Trichinella sp. T9
GECA	Trichinella patagoniensis
GECB	Peribolaster folliculatus
GECC	Psathyrometra fragilis
GECD	Arbacia punctulata
GECE	Abyssocucumis albatrossi
GECF	Rousettus aegyptiacus
GECG	Halocafeteria seosinensis
GECH	Pharyngomonas kirbyi
GECI	Crassostrea gigas
GECJ	Trichinella pseudospiralis
GECK	Rhodnius prolixus
GECL	Triatoma dimidiata
GECM	Drosophila montana
GECN	Diachasma alloeum
GECO	Pinus patula
GECP	Crotalus simus
GECQ	Murgantia histrionica
GECR	Zea mays
GECS	Zea mays
GECT	Pteromalus puparum
GECU	Homalodisca liturata
GECV	Microhyla fissipes
GECX	Catostomus commersonii
GECZ	Cuerna arida
GEDA	Coregonus maraena
GEDB	Polistes dominula
GEDC	Clastoptera arizonana
GEDD	Nicotiana attenuata
GEDE	Miscanthus lutarioriparius
GEDF	Astacus astacus
GEDG	Solanum chacoense
GEDH	Phyllostachys praecox
GEDJ	Haliotis discus hannai
GEDK	Neodiprion lecontei
GEDL	Triticum polonicum
GEDM	Neodiprion lecontei
GEDN	Sarcophilus harrisii
GEDO	Conogethes punctiferalis
GEDP	Triticum polonicum
GEDQ	Triticum polonicum
GEDR	Bothrops atrox
GEDS	Paracentrotus lividus
GEDT	Triticum polonicum
GEDU	Jatropha curcas
GEDV	Rhipicephalus appendiculatus
GEDW	Watasenia scintillans
GEDX	Watasenia scintillans
GEDY	Halyomorpha halys
GEDZ	Watasenia scintillans
GEEA	Bactrocera dorsalis
GEEB	Senna alexandrina
GEEC	Mangifera indica
GEED	Hibiscus cannabinus
GEEE	Schistocephalus solidus
GEEF	Leptinotarsa decemlineata
GEEG	Monocercomonoides exilis
GEEH	Hieracium piloselloides subsp. praealtum
GEEI	Acrostichum aureum
GEEJ	Acrostichum speciosum
GEEK	Ceratopteris thalictroides
GEEL	Monocercomonoides exilis
GEEM	Trichoplusia ni
GEEN	Rhodotorula toruloides
GEEO	Aureobasidium melanogenum
GEEP	Penaeus monodon
GEEQ	Oxybasis rubra
GEER	Camellia reticulata
GEES	Neodiprion lecontei
GEET	Physalis peruviana
GEEU	Ettlia oleoabundans
GEEV	Cryptocaryon irritans
GEEW	Mytilus edulis
GEEX	Amblyomma sculptum
GEEY	Cephus cinctus
GEEZ	Rhipicephalus microplus
GEFA	Rhipicephalus microplus
GEFB	Cancer borealis
GEFC	Thamnodynastes strigatus
GEFD	Cephus cinctus
GEFE	Philodryas olfersii
GEFF	Pocillopora damicornis
GEFG	Cephus cinctus
GEFH	Hyalomma excavatum
GEFI	Rhipicephalus appendiculatus
GEFJ	Rhipicephalus appendiculatus
GEFK	Erythrolamprus miliaris
GEFL	Oxyrhopus guibei
GEFM	Ixodes ricinus
GEFN	Palaemon argentinus
GEFO	Marchantia polymorpha
GEFP	Arachis hypogaea
GEFQ	Camellia sinensis
GEFR	Euglena gracilis
GEFS	Bromus tectorum
GEFT	Eriocheir sinensis
GEFU	Paulownia tomentosa
GEFV	Paulownia tomentosa
GEFW	Atractylodes lancea
GEFX	Persicaria minor
GEFY	Camellia oleifera
GEFZ	Atractylodes lancea
GEGA	Atractylodes lancea
GEGB	Opsanus beta
GEGC	Opsanus beta
GEGD	Opsanus beta
GEGE	Opsanus beta
GEGF	Zhangixalus omeimontis
GEGG	Rhacophorus dennysi
GEGH	Polypedates megacephalus
GEGI	Pelophylax nigromaculatus
GEGJ	Odorrana margaretae
GEGK	Leptobrachium boringii
GEGL	Megophrys sangzhiensis
GEGM	Nicotiana tabacum
GEGN	Arthrinium malaysianum
GEGO	Ixodes ricinus
GEGP	Phagocata gracilis
GEGR	Arthrinium malaysianum
GEGS	Schizothorax prenanti
GEGT	Gymnocypris przewalskii przewalskii
GEGU	Channa argus
GEGV	Plutella xylostella
GEGW	Arthrinium malaysianum
GEGX	Salmo salar
GEGY	Salmo salar
GEGZ	Mangrovibacter sp. MFB070
GEHA	Sargassum vulgare
GEHB	Girardia sp. Sanchez-2016
GEHC	Aedes albopictus
GEHD	Leucocoprinus sp. HH-2015e
GEHE	Leucocoprinus sp. HH-2015d
GHFG	Eospalax fontanierii
GHFH	Haemulon macrostomum
GHFI	Eleutherobia rubra
GHFK	Haemulon flavolineatum
GHFL	Nothofagus pumilio
GHFM	Strongylocentrotus purpuratus
GHFN	Hypericum perforatum
GHFO	Bombus terrestris
GHFP	Osmia cornuta
GHFQ	Bombus pascuorum
GHFR	Andrena fulva
GHFS	Bombus terrestris
GHFT	Osmia cornuta
GHFU	Andrena haemorrhoa
GHFV	Bombus pascuorum
GHFW	Andrena cineraria
GHFX	Osmia cornuta
GHFY	Bombus pascuorum
GHFZ	Bombus pascuorum
GHGA	Andrena haemorrhoa
GHGB	Bombus terrestris
GHGC	Osmia bicornis
GHGD	Bombus cryptarum
GHGE	Tachycineta bicolor
GHGF	Silurus asotus
GHGG	Suaeda salsa
GHGH	Acropora millepora
GHGI	Paeonia suffruticosa
GHGJ	Haliotis discus
GHGK	Sphaeridiotrema pseudoglobulus
GHGL	Psilotrema simillimum
GHGM	Acropora millepora
GHGN	Acropora millepora
GHGO	Acropora millepora
GHGP	Pampus argenteus
GHGQ	Acropora millepora
GHGR	Salmo trutta fario
GHGS	Acropora millepora
GHGT	Acropora millepora
GHGU	Acropora millepora
GHGV	Pseudopleuronectes americanus
GHGW	Rhynchomesostoma sp. ER-2019
GHGX	Fagus crenata
GHGY	Paralithodes camtschaticus
GHGZ	Achaea janata
GHHA	Panicum miliaceum
GHHB	Lolium rigidum
GHHC	Bromus tectorum
GHHD	Sorghum halepense
GHHE	Microplitis mediator
GHHF	Konosirus punctatus
GHHG	Hydra vulgaris
GHHH	Hofstenia miamia
GHHI	Drosophila melanogaster
GHHJ	Drosophila suzukii
GHHK	Eulimnogammarus verrucosus
GHHL	Chelifer cancroides
GHHM	Ipomoea batatas
GHHN	Drosophila biarmipes
GHHO	Drosophila subpulchrella
GHHP	Schistocerca gregaria
GHHQ	Neverita didyma
GHHR	Holothuria scabra
GHHS	Holothuria scabra
GHHU	Gammarus lacustris
GHHV	Micropterus salmoides
GHHW	Eulimnogammarus cyaneus
GHIF	Triaenophorus nodulosus
GHIG	Amphibalanus improvisus
GHII	Mytilus edulis
GHIJ	Mytilus trossulus
GHIK	Mytilus galloprovincialis
GHIL	Nephromyces sp. ex Molgula occidentalis
GHIM	Amphibalanus improvisus
GHIN	Sporolithon sp.
GHIO	Porolithon sp.
GHIP	Lithothamnion proliferum
GHIQ	Homo sapiens
GHIR	Homo sapiens
GHIS	soil metagenome
GHIT	Amblyseius swirskii
GHIU	Puccinia novopanici
GHIV	Lithophyllum sp.
GHIW	Dreissena polymorpha
GHIX	Dreissena rostriformis bugensis
GHIY	Melastoma malabathricum
GHIZ	Gnathostoma spinigerum
GHJA	Medicago archiducis-nicolai
GHJB	Ananas comosus var. bracteatus
GHJC	Paralithodes camtschaticus
GHJD	Oratosquilla oratoria
GHJE	Harmonia axyridis
GHJF	Dionaea muscipula
GHJG	Paris polyphylla
GHJH	Paris polyphylla
GHJJ	Crassostrea virginica
GHJK	Chelon auratus
GHJL	Anas platyrhynchos
GHJN	Patiria miniata
GHJO	Epinephelus coioides
GHJP	Emiliania huxleyi
GHJQ	Digitalis ferruginea subsp. schischkinii
GHJR	Lates calcarifer
GHJS	Aquilaria malaccensis
GHJT	Ixodes scapularis
GHJU	Quercus castanea
GHJV	Tetramorium immigrans
GHJW	Tetramorium parvispinum
GHJX	Tetramorium simillimum
GHJY	Tetramorium bicarinatum
GHJZ	Mesocentrotus franciscanus
GHKA	Citrus limon
GHKB	Trichosurus vulpecula
GHKC	Tetramorium alpestre
GHKD	Saccharum hybrid cultivar
GHKE	Dissostichus eleginoides
GHKF	Taricha granulosa
GHKG	Schizothorax prenanti
GHKH	Sthenoteuthis oualaniensis
GHKI	Aspidiotus rigidus
GHKJ	Rhodnius prolixus
GHKK	Onychoteuthis banksii
GHKL	Dosidicus gigas
GHKM	Strigamia maritima
GHKN	Lithobius forficatus
GHKO	Scutigera coleoptrata
GHKP	Craterostigmus tasmanianus
GHKQ	Scolopendra morsitans
GHKR	Areca catechu
GHKS	Karenia mikimotoi
GHKT	Suaeda salsa
GHKU	Spodoptera frugiperda
GHKV	Gomphocerus sibiricus
GHKW	Pinus sylvestris
GHKX	Pinus sylvestris
GHKY	Pinus sylvestris
GHKZ	Asterias rubens
GHLA	Pinus sylvestris
GHLB	Neocalanus flemingeri
GHLC	Brachymystax lenok tsinlingensis
GHLD	Eschweilera sagotiana
GHLE	Gustavia augusta
GHLF	Gustavia superba
GHLG	Gustavia superba
GHLH	Lecythis congestiflora
GHLI	Lecythis persistens
GHLJ	Napoleonaea imperialis
GHLK	Grias cauliflora
GHLL	Ginkgo biloba
GHLM	Barringtonia racemosa
GHLN	Couroupita guianensis
GHLO	Eschweilera coriacea
GHLP	Eschweilera coriacea
GHLS	Osmerus mordax
GHLT	Haemaphysalis longicornis
GHLU	Tetradesmus obliquus
GHLW	Chlorella vulgaris
GHLX	Chlorella vulgaris
GHLY	Harmonia axyridis
GHLZ	Fredericella sultana
GHMA	Dichotomius satanas
GHMB	Trialeurodes vaporariorum
GHMC	Dynamena pumila
GHMD	Onthophagus curvicornis
GHME	Bolitoglossa vallecula
GHMF	Trypanosomatidae sp. Fi-14
GHMG	Macrobrachium nipponense
GHMI	Sillago sinica
GHMJ	Allium cepa
GHMK	Allium ericetorum
GHML	Allium nutans
GHMM	Allium fistulosum
GHMN	Scilla peruviana
GHMO	Cestrum elegans
GHMP	Allium angulosum
GHMQ	Allium ursinum
GHMR	Tulbaghia violacea
GHMS	Reticulitermes aculabialis
GHMT	Trigonella foenum-graecum
GHMU	Mucor irregularis
GHMV	Prorocentrum micans
GHMW	Prorocentrum donghaiense
GHMX	Prorocentrum minimum
GHMY	Haematobia irritans
GHMZ	Zhangixalus omeimontis
GHNA	Trigonella foenum-graecum
GHNB	Paris polyphylla var. yunnanensis
GHND	Trigonella foenum-graecum
GHNE	Trigonella foenum-graecum
GHNF	Capparis spinosa subsp. rupestris
GHNG	Paris polyphylla var. yunnanensis
GHNH	Paris polyphylla var. yunnanensis
GHNI	Paris polyphylla var. yunnanensis
GHNJ	Diabrotica virgifera virgifera
GHNK	Grapholitha molesta
GHNL	Taxillus chinensis
GHNM	Saccharina latissima
GHNN	Kryptolebias hermaphroditus
GHNO	Oryctes rhinoceros
GHNP	Reticulitermes labralis
GHNR	Hymenolepis diminuta
GHNT	Isatis tinctoria
GHNU	Mugil incilis
GHNV	Danionella translucida
GHNW	Meriones unguiculatus
GHNX	Muraenesox cinereus
GHNY	Erucaria erucarioides
GHNZ	Ceracris nigricornis
GHOA	Hemistasia phaeocysticola
GHOB	Trypanoplasma borreli
GHOC	Aspidelaps scutatus
GHOD	Trachyspermum ammi
GHOE	Macadamia integrifolia
GHOF	Persea americana
GHOG	Mangifera indica
GHOH	Digitaria ciliaris
GHOI	Metacarcinus magister
GHOJ	Lysmata amboinensis
GHOL	Panagrolaimus sp. DL0137
GHOM	Panagrolaimus sp. PS1579
GHON	Panagrolaimus sp. ES5
GHOO	Panagrolaimus sp. PS1159
GHOP	Panagrolaimus sp. JU765
GHOQ	Dispholidus typus
GHOR	Cakile lanceolata
GHOS	Peruphasma schultei
GHOT	Celmisia lyallii
GHOU	Girardia sp. n. ER-2019
GHOW	Dermacentor reticulatus
GHOY	Jasminum sambac
GHOZ	Clioperla clio
GHPA	Dendroaspis jamesoni jamesoni
GHPB	Dendroaspis jamesoni kaimosae
GHPC	Dendroaspis viridis
GHPD	Dendroaspis polylepis
GHPE	Littorina saxatilis
GHRC	Panicum laetum
GHRD	Panicum turgidum
GHRE	Panicum bisulcatum
GHRJ	Bicyclus anynana
GHRK	Diabrotica virgifera virgifera
GHRL	Dreissena rostriformis
GHRM	Bactrocera oleae
GHRN	Heliconius numata
GHRO	Lantana camara
GHRP	Chlorella sp. CH2018
GHRQ	Tetradesmus deserticola
GHRR	Flechtneria rotunda
GHRS	Trachurus trachurus
GHRT	Scomber scombrus
GHRU	Digyalum oweni
GHRV	Naja haje
GHRW	Naja kaouthia
GHRX	Naja naja
GHRY	Micromesistius poutassou
GHRZ	Trisopterus luscus
GHSA	Liriodendron chinense
GHTP	Salicornia neei
GHTQ	Liquidambar styraciflua
GHTR	Liquidambar formosana
GHTS	Liriodendron tulipifera
GHTT	Populus tomentosa
GHTU	Salix aegyptiaca
GHTV	Salix babylonica
GHTW	Salix chaenomeloides
GHTX	Etheostoma spectabile
GHTY	Paracoccidioides brasiliensis Pb18
GHTZ	Prorocentrum micans
GHUB	Gloydius intermedius
GHUC	Hydra oligactis
GHUE	Tigriopus californicus
GHUF	Quercus pubescens
GHUG	Quercus ilex
GHUH	Quercus robur
GHUI	Chionochloa pallens
GHUJ	Panulirus argus
GHUK	Mougeotia sp. MZCH-SVCK 240
GHUL	Littorina saxatilis
GHUM	Littorina saxatilis
GHUN	Dioscorea polystachya
GHUO	Thelotornis mossambicanus
GHUP	Leptopilina heterotoma
GHUQ	Leptopilina heterotoma
GHUR	Desmodus rotundus
GHUS	Cuscuta denticulata
GHUT	Cuscuta nevadensis
GHUU	Acheta domesticus
GHUV	Enallax costatus
GHUW	Bactericera trigonica
GHUX	Centranthera grandiflora
GHUY	Penaeus chinensis
GHUZ	Castanea crenata
GHVB	Ceiba aesculifolia
GHVD	Gammarus fossarum
GHVE	Petromyzon marinus
GHVF	Cannabis sativa
GHVG	Cannabis sativa
GHVH	Cephaloidophora cf. communis
GHVI	Gynostemma pentaphyllum
GHVJ	Perca fluviatilis
GHVK	Prunus mira
GHVL	Digyalum oweni
GHVM	Digyalum oweni
GHVN	Selenidium pygospionis
GHVO	Ancora sagittata
GHVP	Polyrhabdina sp. WS-2016
GHVQ	Rhytidocystis sp. ex Ophelia limacina
GHVR	Apicomplexa sp. symbiont X
GHVS	Rhytidocystis sp. ex Travisia forbesii
GHVT	Eleutheroschizon duboscqi
GHVU	Siedleckia nematoides
GHVV	Siedleckia nematoides
GHVW	Pisum sativum
GHVX	Acheta domesticus
GHVY	Diadegma insulare
GHVZ	Diadegma insulare
GHWA	Cymbastela stipitata
GHWB	Pinus flexilis
GHWC	Pinus flexilis
GHWD	Siniperca chuatsi
GHWE	Pinus flexilis
GHWF	Epinephelus fuscoguttatus
GHWG	Arthrinium phaeospermum
GHWH	Sinonovacula constricta
GHWJ	Rhipicephalus microplus
GHWK	Phakopsora pachyrhizi
GHWL	Phakopsora pachyrhizi
GHWM	Albizia julibrissin
GHWN	Entada abyssinica
GHWO	Microlobius foetidus
GHWP	Phakopsora pachyrhizi
GHWQ	Phakopsora pachyrhizi
GHWR	Phakopsora pachyrhizi
GHWS	Phakopsora pachyrhizi
GHWT	Scutiger cf. sikimmensis SH-2019
GHWV	Pseudodiaptomus annandalei
GHWW	Ophrys insectifera subsp. aymoninii
GHWX	Ophrys insectifera
GHWY	Kalotermes flavicollis
GHWZ	Entylia carinata
GHXA	Homalodisca vitripennis
GHXB	Termitogeton planus
GHXC	Amitermes sp. AB-2019
GHXD	Haematobia irritans
GHXE	Gymnadenia x densiflora
GHXF	Gymnadenia odoratissima
GHXG	Gymnadenia conopsea
GHXH	Gymnadenia rhellicani
GHXI	Ophrys fusca subsp. iricolor
GHXJ	Ophrys sphegodes
GHXK	Platychelipus littoralis
GHXL	Nippostrongylus brasiliensis
GHXM	Camellia sinensis
GHXN	Ixodes ricinus
GHXO	Acalymma vittatum
GHXP	Haematobia irritans
GHXR	Micromonas polaris
GHXS	Hormiphora californensis
GHXT	Thalictrum hernandezii
GHXU	Thalictrum thalictroides
GHXV	Penaeus vannamei
GHXW	Eretmochelys imbricata
GHXX	Salinicola sp. MFB021
GHXY	Beroe forskalii
GHXZ	Schizothorax plagiostomus
GHYA	Schizopyge nukiangensis
GHYB	Schizothorax lissolabiata
GHYC	Platypharodon extremus
GHYD	Schizothorax davidi
GHYE	Schizothorax labiatus
GHYF	Schizothorax oconnori
GHYG	Gymnocypris eckloni
GHYH	Gymnocypris namensis
GHYI	Schizopygopsis selincuoensis
GHYJ	Gymnocypris przewalskii
GHYK	Schizopygopsis pylzovi
GHYL	Schizopygopsis younghusbandi
GHYM	Ptychobarbus kaznakovi
GHYN	Bactrocera oleae
GHYO	Ipomoea batatas
GHYP	Stevia rebaudiana
GHYQ	Haematobia irritans
GHYR	Octopus maya
GHYS	Prorhinotermes inopinatus
GHYT	Pseudacanthotermes militaris
GHYU	Quasitermes incisus
GHYV	Microcerotermes sp. AB-2019
GHYW	Agnathotermes crassinasus
GHYX	Anoplotermes banksi
GHYY	Astratotermes sp. AB-2019
GHYZ	Aparatermes sp. AB-2019
GHZA	Atlantitermes osborni
GHZB	Basidentitermes aurivillii
GHZC	Bifiditermes mutubae
GHZD	Cephalotermes rectangularis
GHZE	Cavitermes tuberosus
GHZF	Constrictotermes cavifrons
GHZG	Cornitermes pugnax
GHZH	Cubitermes sp. AB-2019
GHZI	Dicuspiditermes cf. laetus AB-2019
GHZJ	Coptotermes acinaciformis
GHZK	Dentispicotermes brevicarinatus
GHZL	Epicalotermes kempae
GHZM	Cryptotermes secundus
GHZN	Embiratermes neotenicus
GHZO	Euhamitermes sp. AB-2019
GHZP	Globitermes sulphureus
GHZQ	Glossotermes oculatus
GHZR	Glyptotermes parvulus
GHZS	Heterotermes malabaricus
GHZT	Heterotermes tenuior
GHZU	Heterotermes tenuis
GHZV	Hospitalitermes sp. AB-2019
GHZW	Indotermes sp. 1 AB-2019
GHZX	Jugositermes tuberculatus
GHZY	Leptomyxotermes doriae
GHZZ	Heterotermes ferox
GIAA	Labiotermes labralis
GIAB	Nasutitermes sp. AB-2019
GIAC	Neotermes castaneus
GIAD	Palmitermes impostor
GIAE	Pericapritermes sp. AB-2019
GIAF	Promirotermes sp. AB-2019
GIAG	Porotermes quadricollis
GIAH	Serritermes serrifer
GIAI	Sphaerotermes sphaerothorax
GIAJ	Spinitermes trispinosus
GIAK	Stylotermes halumicus
GIAL	Rhinotermes hispidus
GIAM	Schedorhinotermes intermedius
GIAN	Schedorhinotermes sp. AB-2019
GIAO	Indotermes sp. 2 AB-2019
GIAP	Occasitermes sp. AB-2019
GIAQ	Acropora digitifera
GIAR	Seriatopora caliendrum
GIAS	Archivesica marissinica
GIAT	Phreagena okutanii
GIAU	Lucifuga dentata
GIAV	Amomum subulatum
GIAW	Amomum subulatum
GIBA	Pomphorhynchus laevis
GIBB	Caretta caretta
GIBK	Colias croceus
GIBL	Bothriechis nigroviridis
GIBM	Bothriechis nubestris
GIBN	Anopheles gambiae
GIBO	Oxygymnocypris stewartii
GIBP	Arcella intermedia
GIBQ	Ixodes holocyclus
GIBR	Pinus pinaster
GIBS	Nymphaea thermarum
GIBT	Brassica oleracea var. capitata
GIBU	Sequoia sempervirens
GIBW	Nezara viridula
GIBX	Bemisia tabaci
GIBZ	Mongolotettix japonicus
GICA	Gomphocerus licenti
GICB	Acipenser baerii
GICC	Bemisia tabaci
GICD	Acipenser baerii
GICE	Breviolum minutum
GICF	Spirogyra pratensis
GICG	Austropotamobius pallipes
GICI	Parargyrops edita
GICJ	Xanthoceras sorbifolium
GICK	Turnera subulata
GICL	Crassostrea gigas x Crassostrea sikamea
GICO	Ferula assa-foetida
GICQ	Astyanax lacustris
GICR	marine plankton metagenome
GICS	Odorrana tormota
GICT	Homalodisca vitripennis
GIDF	Sequoia sempervirens
GIDG	Ixodes ricinus
GIDH	Amblyomma tuberculatum
GIDI	coral metagenome
GIDJ	Medicago lupulina
GIDK	Mesocapnia frisoni
GIDL	Pictetiella expansa
GIDM	Ostrocerca foersteri
GIDN	Chernokrilus misnomus
GIDO	Sweltsa lamba
GIDP	Viehoperla ada
GIDQ	Paraleuctra sara
GIDS	Misgurnus anguillicaudatus
GIDT	Helopicus subvarians
GIDU	Utacapnia logana
GIDV	Capnia confusa
GIDW	Allocapnia granulata
GIDX	Nemocapnia carolina
GIDY	Capnura wanica
GIDZ	Podmosta delicatula
GIEA	Moselia infuscata
GIEB	Zapada oregonensis
GIEC	Eucapnopsis brevicauda
GIED	Malirekus iroquois
GIEE	Amphinemura delosa
GIEF	Hydroperla crosbyi
GIEG	Plumiperla diversa
GIEH	Pomoleuctra purcellana
GIEI	Setvena bradleyi
GIEJ	Salmoperla sylvanica
GIEK	Arcynopteryx dichroa
GIEL	Cultus tostonus
GIEM	Susulus venustus
GIEN	Rickera sorpta
GIEO	Megarcys subtruncata
GIEP	Diploperla robusta
GIEQ	Haploperla brevis
GIER	Cascadoperla trictura
GIES	Zealeuctra claasseni
GIET	Soliperla sp. INHS 658482
GIEU	Perlomyia collaris
GIEV	Visoka cataractae
GIEW	Sierraperla cora
GIEX	Nemoura arctica
GIEY	Diura knowltoni
GIEZ	Soyedina vallicularia
GIFA	Arsapnia decepta
GIFC	Ixodes ricinus
GIFE	Dasyrhicnoessa insularis
GIFF	Curtonotum sp. curtcr05
GIFG	Stegana sp. stegsp06
GIFH	Cairnsimyia uniseta
GIFI	Halisarca dujardini
GIFJ	Halichondria panicea
GIFK	Phlebotomus kandelakii
GIFL	Ligustrum quihoui
GIFM	Diplogeomyza tridens
GIFN	Opomyza germinationis
GIFO	Paraleucopidae sp. par10
GIFP	Cannabis sativa
GIFQ	mite metagenome
GIFR	Nemo dayi
GIFS	Scutops sp. per11
GIFT	Auster sp. ter15
GIFV	Lumbricus rubellus
GIFZ	Dermanyssus gallinae
GIGA	Acrolophitus hirtipes
GIGB	Schistocerca americana
GIGC	Stenacris vitreipennis
GIGD	Aidemona azteca
GIGE	Melanoplus confusus
GIGF	Trimerotropis pallidipennis
GIGG	Amblytropidia mysteca
GIGH	Arphia xanthoptera
GIGI	Chortophaga viridifasciata
GIGJ	Haliotis discus hannai
GIGK	Alligator sinensis
GIGL	Syringogaster plesioterga
GIGM	Stylogaster sp. stype02
GIGO	Willistoniella sp. NUS_DPA_2014
GIGP	Acartophthalmus nigrinus
GIGQ	Leiomyza laevigata
GIGR	Meghyperus sp. megca01
GIGS	Aulacigaster mcalpinei
GIGT	Gymnochiromyia sp. gymcr03
GIGU	Cryptochetum sp. cry04
GIGV	Strongylophthalmyia sp. QLD02
GIGW	Odinia conspicua
GIGX	Ligustrum x vicaryi
GIHN	Panulirus argus
GIHP	Dalbergia frutescens
GIHQ	Dalbergia melanoxylon
GIHR	Dalbergia miscolobium
GIHS	Dalbergia oliveri
GIHT	Dalbergia sissoo
GIHU	Dalbergia cochinchinensis
GIHV	Wyochernes asiaticus
GIIE	Pinus strobus
GIIF	Panonychus citri
GIIH	Heterotrigona itama
GIIL	Xenopsylla cheopis
GIIM	Gigantidas vrijenhoeki
GIIO	Achaea janata
GIIS	Menispermum canadense
GIIT	Sinomenium acutum
GIIU	Stephania japonica
GIJA	Rhipicephalus haemaphysaloides
GIJB	Vipera aspis
GIJC	Hemachatus haemachatus
GIJD	Naja annulifera
GIJE	Naja atra
GIJF	Naja mossambica
GIJG	Naja nigricollis
GIJH	Naja nivea
GIJI	Naja nubiae
GIJJ	Naja pallida
GIJK	Naja philippinensis
GIJL	Naja siamensis
GIJM	Naja subfulva
GIJN	Naja sumatrana
GIJO	Walterinnesia aegyptia
GIJQ	Gambierdiscus pacificus
GIJR	Gambierdiscus polynesiensis
GIJS	Triticum aestivum
GIJU	Pachygrapsus marmoratus
GIJV	Brachyteles arachnoides
GIJW	Octolasmis warwickii
GIJX	Glyptelasma gigas
GIJY	Wolbachia endosymbiont of Tyrophagus putrescentiae
GIJZ	Botrychium lunaria
GIKA	invertebrate metagenome
GIKD	Jatropha curcas
GIKF	Amynthas gracilis
GIKG	Eisenia fetida
GIKI	Lumbricus rubellus
GIKJ	Haemaphysalis longicornis
GIKK	Salamandra salamandra
GIKM	Neodiprion pinetum
GIKN	Rhipicephalus microplus
GIKO	Chlorella sp. HS2
GIKP	Achaea janata
GIKQ	Achaea janata
GIKS	Oophaga pumilio
GIKT	Rhododendron molle
GIKU	Odontomachus brunneus
GIKV	Gecarcoidea lalandii
GIKZ	Puccinia triticina
GILA	Patella vulgata
GILB	Populus davidiana
GILD	Agarophyton vermiculophyllum
GILE	Elaphe carinata
GILI	Colponema vietnamica
GILJ	Colponemidia sp. Colp-10
GILK	Colponemidia sp. Colp-15
GILM	Tachypleus gigas
GILN	Pinus sylvestris
GILO	Pinus sylvestris
GILP	Pinus sylvestris
GILQ	Carcinoscorpius rotundicauda
GILR	Dendroaspis angusticeps
GILS	Myrciaria dubia
GILT	Myrciaria dubia
GILU	Myrciaria dubia
GILX	Chrysaora quinquecirrha
GILY	Triticum aestivum
GILZ	Luffa aegyptiaca
GIMC	Macoma calcarea
GIMF	Selaginella sellowii
GIMG	Selaginella lepidophylla
GIMH	Selaginella denticulata
GIMI	wood decay metagenome
GIML	Schizaphis graminum
GIMM	Altererythrobacter sp.
GIMN	Rubrivivax sp.
GIMO	Rubrivivax sp.
GIMP	Altererythrobacter sp.
GIMQ	Novosphingobium sp.
GIMR	Porphyrobacter sp.
GIMS	Elaphe carinata
GIMT	Ambrosia trifida
GINI	Alitta virens
GINJ	Trissolcus basalis
GINK	Trissolcus basalis
GINL	Trissolcus basalis
GINM	Trissolcus basalis
GINN	Trissolcus basalis
GINO	Trissolcus basalis
GINV	Rhipicephalus sanguineus
GINX	Thunnus albacares
GINY	Boana pugnax
GINZ	Brachionus rotundiformis
GIOC	Ankistrodesmus falcatus
GIOE	Solanum tuberosum
GIOF	Silene noctiflora
GIOH	Cavenderia bifurcata
GIOI	Cavenderia multistipes
GIOK	Blakeslea trispora
GIOM	Cavenderia parvispora
GION	Raperostelium australe
GIOO	Raperostelium gracile
GIOP	Amia calva
GIOR	Schistocerca piceifrons
GIOS	Schistocerca piceifrons
GIOT	Schistocerca americana
GIOU	Schistocerca americana
GIOV	Schistocerca serialis cubense
GIOW	Schistocerca nitens
GIOX	Raperostelium potamoides
GIOY	Hagiwaraea rhizopodium
GIOZ	Gloriosa superba
GIPA	Heterostelium gloeosporum
GIPB	Hypothenemus hampei
GIPC	Schistocerca serialis cubense
GIPD	Schistocerca nitens
GIPF	Tieghemostelium menorah
GIPI	Plantago lanceolata
GIPK	Penicillium janthinellum
GIPN	Platichthys flesus
GIPO	Lithobates yavapaiensis
GIPP	Dictyostelium brefeldianum
GIPR	Holothuria forskali
GIPS	Dictyostelium capitatum
GIQE	Dictyostelium gargantuum
GIQF	Dictyostelium rosarium
GIQG	Filasterea sp. DVT-2020a
GIQJ	Orobanche cernua var. cumana
GIQR	Nitzschia sp. Nitz4
GIQU	Iris germanica
GIQV	Solanum sitiens
GIQZ	Charonia lampas
GIRA	Alternanthera philoxeroides
GIRB	Alternanthera philoxeroides
GIRC	Alternanthera philoxeroides
GIRD	Alternanthera philoxeroides
GIRE	Alternanthera philoxeroides
GIRF	Alternanthera philoxeroides
GIRG	Alternanthera philoxeroides
GIRI	coral metagenome
GIRK	Alternanthera philoxeroides
GIRL	Alternanthera philoxeroides
GIRM	Alternanthera philoxeroides
GIRN	Alternanthera philoxeroides
GIRO	Alternanthera philoxeroides
GIRP	Alternanthera philoxeroides
GIRQ	Alternanthera philoxeroides
GIRR	Alternanthera philoxeroides
GIRS	Alternanthera philoxeroides
GIRT	Alternanthera philoxeroides
GIRU	Alternanthera philoxeroides
GIRV	Rhinolophus affinis
GIRW	Rhinolophus affinis
GIRX	Myotis ricketti
GIRZ	Astroides calycularis
GISA	Alternanthera philoxeroides
GISB	Juniperus flaccida
GISC	Boana pugnax
GISD	Pinus cembroides
GISG	Opuntia streptacantha
GISI	Stevia rebaudiana
GISJ	Cryptocotyle lingua
GISK	Callionymus lyra
GISL	Busseola fusca
GISM	Rapana venosa
GISO	Camellia chekiangoleosa
GISQ	Stevia rebaudiana
GISR	Karenia mikimotoi
GIST	Epimedium pseudowushanense
GISU	Clarkia gracilis subsp. sonomensis
GISV	Clarkia gracilis subsp. sonomensis
GISX	Leptopilina boulardi
GISY	Puccinia triticina
GISZ	Busseola fusca
GITA	Busseola fusca
GITB	Busseola fusca
GITC	Leptopilina boulardi
GITD	Busseola fusca
GITE	Busseola fusca
GITF	Busseola fusca
GITG	Busseola fusca
GITH	Busseola fusca
GITI	Busseola fusca
GITJ	Busseola fusca
GITK	Bombyx mori
GITM	Tetragnatha brevignatha
GITN	Tetragnatha filiciphilia
GITO	Tetragnatha paludicola
GITP	Tetragnatha quasimodo
GITQ	Tetragnatha stelarobusta
GITR	Tetragnatha waikamoi
GITT	Pinus massoniana
GITU	Lutzomyia longipalpis
GITX	Diplogasteroides magnus
GITY	Levipalatum texanum
GITZ	Bunonema sp. RGD898
GIUA	Koerneria luziae
GIUB	Sinotaia purificata
GIUD	Allodiplogaster sudhausi
GIUE	Pinctada margaritifera
GIUF	Tridacna maxima
GIUH	estuary metagenome
GIUI	Fallopia convolvulus
GIUJ	Agave lechuguilla
GIUK	Eisenia fetida
GIUL	Coregonus artedi
GIUM	Pinctada maxima
GIUO	Thunnus orientalis
GIUQ	Lilium longiflorum
GIUR	Paspalum notatum
GIVA	Procambarus erythrops
GIVC	Mytilus edulis
GIVD	Rhincalanus gigas
GIVE	Cardiosporidium cionae
GIVF	Chinavia impicticornis
GIVG	Seriatopora caliendrum
GIVH	Xenopus tropicalis
GIVI	Acropora digitifera
GIVL	Holothuria glaberrima
GIVM	Montipora digitata
GIVN	Favites colemani
GIWC	Coreopsis tinctoria
GIWD	Brachionus angularis
GIWK	Lethenteron camtschaticum
GIWL	Badumna longinqua
GIWQ	Desis marina
GIWR	Argyroneta aquatica
GIWS	Ips confusus
GIWU	Ginglymostoma cirratum
GIWV	Dendroctonus valens
GIXB	Selenicereus undatus
GIXE	Scylla paramamosain
GIXF	Tetrastigma hemsleyanum
GIXK	Pinus halepensis
GIXL	Ixodes ricinus
GIXO	Solanum tuberosum
GIXP	Ornithodoros moubata
GIXQ	Penaeus merguiensis
GIXS	Takifugu poecilonotus
GIXT	Triticum aestivum
GIXV	Kalanchoe marnieriana
GIXW	Potamilus streckersoni
GIXX	Ornithodoros erraticus
GIXY	Aureobasidium melanogenum
GIXZ	Ornithonyssus sylviarum
GIYA	Freesia hybrid cultivar
GIYE	Penaeus chinensis
GIYF	Trachycarpus fortunei
GIYG	Ixodes ricinus
GIYI	Rimicaris exoculata
GIYJ	Bryophyllum daigremontianum
GIYP	Cenostigma pyramidale
GIYQ	Brachionus paranguensis
GIYR	Diospyros kaki
GIYS	Pinus taeda
GIYX	Myxozoa sp. AK-2018
GIZK	Myxidium lieberkuehni
GIZL	Rhipicephalus microplus
GIZM	Schizocosa ocreata
GIZN	Schizocosa ocreata
GIZO	Schizocosa ocreata
GIZP	Schizocosa ocreata
GIZQ	Schizocosa ocreata
GIZR	Schizocosa ocreata
GIZS	Schizocosa ocreata
GIZT	Schizocosa ocreata
GIZU	Schizocosa ocreata
GIZV	Schizocosa ocreata
GIZW	Schizocosa ocreata
GIZX	Porichthys notatus
GJAA	Potamilus streckersoni
GJAG	Urochondra setulosa
HAAA	Pneumocystis jirovecii
HAAB	Triticum aestivum
HAAC	Hydra vulgaris
HAAD	Hydra vulgaris
HAAF	Neovison vison
HAAG	Neovison vison
HAAH	Stephanoeca diplocostata
HAAI	Hyas araneus
HAAJ	Ambrosia artemisiifolia
HAAK	Rumex acetosa
HAAL	Rumex palustris
HAAM	Cooperia oncophora
HAAN	Leucoagaricus gongylophorus
HAAW	Penaeus vannamei
HAAX	Eriocheir sinensis
HAAY	Cenchrus americanus
HABX	Pagurus bernhardus
HABY	Coenobita clypeatus
HABZ	Quercus suber
HACA	Lepeophtheirus salmonis
HACB	Cherax quadricarinatus
HACC	Rubus hybrid cultivar
HACD	Pseudodiploria strigosa
HACE	Hadronyche infensa
HACG	Arion vulgaris
HACH	Hyas araneus
HACJ	Calanus glacialis
HACK	Cherax quadricarinatus
HACL	Anopheles gambiae
HACM	Spongospora subterranea
HACN	Lindbergichthys nudifrons
HACO	Phytophthora cinnamomi
HACP	Rhipicephalus sanguineus
HACQ	Draba nemorosa
HACR	Draba hispanica
HACS	Arabis verna
HACT	Aubrieta parviflora
HACU	Paracentrotus lividus
HACV	Zostera noltei
HACW	Rhipicephalus sanguineus
HACX	Salix viminalis x (Salix viminalis x Salix schwerinii)
HACY	Fucus ceranoides
HACZ	Olavius algarvensis
HADA	Halisarca dujardini
HADB	Fagus sylvatica
HADC	Gammarus chevreuxi
HADD	Apostichopus japonicus
HADE	Apostichopus japonicus
HADF	Apostichopus japonicus
HADG	Heterorhabditis indica
HADH	Cymodocea nodosa
HADN	Nematostella vectensis
HADO	Nematostella vectensis
HADP	Nematostella vectensis
HADQ	Bombina bombina
HADR	Bombina variegata variegata
HADS	Bombina variegata scabra
HADT	Bombina orientalis
HADU	Bombina bombina
HADV	Bombina variegata variegata
HADW	Iconisemion striatum
HADX	Iconisemion striatum
HADY	Nothobranchius furzeri
HADZ	Nothobranchius kadleci
HAEA	Nothobranchius kadleci
HAEB	Nothobranchius korthausae
HAEC	Nothobranchius korthausae
HAED	Nothobranchius kuhntae
HAEE	Nothobranchius kuhntae
HAEF	Nothobranchius pienaari
HAEG	Nothobranchius pienaari
HAEH	Nothobranchius rachovii
HAEI	Nothobranchius rachovii
HAEJ	Nothobranchius furzeri
HAEK	Gallus gallus
HAEL	Gallus gallus
HAEM	Bragasellus molinai
HAEN	Bragasellus peltatus
HAEO	Proasellus aragonensis
HAEP	Proasellus assaforensis
HAEQ	Proasellus arthrodilus
HAER	Proasellus cantabricus
HAES	Proasellus cavaticus
HAET	Proasellus coxalis
HAEU	Proasellus coiffaiti
HAEV	Proasellus escolai
HAEW	Proasellus ebrensis
HAEX	Proasellus grafi
HAEY	Proasellus granadensis
HAEZ	Proasellus hercegovinensis
HAFA	Proasellus ibericus
HAFB	Proasellus jaloniacus
HAFC	Proasellus karamani
HAFD	Proasellus margalefi
HAFE	Proasellus meridianus
HAFF	Proasellus ortizi
HAFG	Proasellus parvulus
HAFH	Proasellus racovitzai
HAFI	Proasellus rectus
HAFJ	Proasellus solanasi
HAFK	Proasellus spelaeus
HAFL	Proasellus beticus
HAFM	Gammarus pulex
HAFN	Daphnia galeata
HAFO	Uroglena sp. WA34KE
HAFP	Spumella vulgaris
HAFQ	Spumella sp. AR4D6
HAFR	Spumella-like flagellate JBNZ39
HAFS	Pedospumella encystans
HAFT	Spumella-like flagellate JBM08
HAFU	Spumella-like flagellate JBL14
HAFV	Spumella-like flagellate JBC/S23
HAFW	Spumella-like flagellate JBAF33
HAFX	Ochromonas sp. LO244K-D
HAFY	Dinobryon sp. FU22KAK
HAFZ	Spumella-like flagellate JBC07
HAGA	Poteriospumella lacustris
HAGB	Spumella-like flagellate JBNZ41
HAGC	Dinobryon sp. LO226KS
HAGD	Synura sp. LO234KE
HAGE	Poterioochromonas sp. DS
HAGF	Epipyxis sp. PR26KG
HAGG	Geranium pyrenaicum
HAGH	Geranium robertianum
HAGJ	Hucho taimen
HAGK	Crotalus durissus terrificus
HAGL	Phidippus regius
HAGT	Squalus acanthias
HAGU	Squalus acanthias
HAGV	Squalus acanthias
HAGW	Squalus acanthias
HAGX	Acartia tonsa
HAGY	Pachycerianthus borealis
HAGZ	Craterolophus convolvulus
HAHA	Haliclystus auricula
HAHB	Haliclystus sanjuanensis
HAHC	Calvadosia cruxmelitensis
HAHD	Lucernaria quadricornis
HAHE	Eresus cinnaberinus
HAHF	Nephila sp. SGP-2016
HAHG	Hadronyche formidabilis
HAHH	Deinopis subrufa
HAHI	Heteropoda jugulans
HAHJ	Hadronyche cerberea
HAHK	Liphistius sp. SGP-2016
HAHL	Liphistius sp. SGP-2016
HAHM	Liphistius thaleban
HAHN	Liphistius thaleban
HAHO	Pamphobeteus verdolaga
HAHQ	Ascaridia galli
HAHR	Vandenboschia speciosa
HAHS	Vandenboschia speciosa
HAHV	Tisbe holothuriae
HAIB	mixed sample
HAJT	Pristionchus pacificus
HAJU	Pristionchus entomophagus
HAJV	Parapristionchus giblindavisi
HAJW	Pristionchus pseudaerivorus
HAJX	Pristionchus uniformis
HAJY	Pristionchus elegans
HAJZ	Pristionchus maupasi
HAKA	Pristionchus marianneae
HAKB	Pristionchus pacificus
HAKC	Pristionchus fukushimae
HAKD	Pristionchus japonicus
HAKE	Pristionchus atlanticus
HAKF	Pristionchus pacificus
HAKG	Pristionchus brevicauda
HAKH	Pristionchus pacificus
HAKI	Micoletzkya masseyi
HAKJ	Pristionchus pauli
HAKK	Pristionchus quartusdecimus
HAKL	Pristionchus fissidentatus
HAKM	Pristionchus maxplancki
HAKN	Pristionchus pacificus
HAKO	Pristionchus pacificus
HAKP	Pristionchus lheritieri
HAKQ	Pristionchus triformis
HAKR	Pristionchus exspectatus
HAKS	Pristionchus pacificus
HAKT	Pristionchus americanus
HAKU	Pristionchus brevicauda
HAKV	Pristionchus pacificus
HAKW	Pristionchus mayeri
HAKX	Pristionchus clavus
HAKY	Pristionchus lucani
HAKZ	Pristionchus hoplostomus
HALB	Pristionchus arcanus
HALC	Pristionchus boliviae
HALD	Pristionchus pacificus
HALE	Pristionchus exspectatus
HALF	Pristionchus pacificus
HALG	Pristionchus aerivorus
HALH	Pristionchus arcanus
HALL	Crotalus durissus terrificus
HALP	Pristionchus bulgaricus
HALR	Platynereis dumerilii
HALS	Sardina pilchardus
HALT	Sardina pilchardus
HALU	Sardina pilchardus
HALV	Sardina pilchardus
HALW	Sardina pilchardus
HALX	Sardina pilchardus
HALY	Sardina pilchardus
HALZ	Sardina pilchardus
HAMA	Sardina pilchardus
HAMB	Sardina pilchardus
HAMC	Sardina pilchardus
HAMD	Sardina pilchardus
HAMF	Galerucella calmariensis
HAMG	Galerucella pusilla
HAMI	Pinus cembra
HAMJ	Leishmania donovani
HAMK	Paradendryphiella salina
HAML	Rhinella diptycha
HAMM	Gmelina arborea
HAMN	Platynereis dumerilii
HAMO	Platynereis dumerilii
HAMP	unidentified sea urchin
HAMR	invertebrate metagenome
HAMS	Kewa bowkeriana
HAMT	Simmondsia chinensis
HAMU	Clytia hemisphaerica
HAMV	Clytia hemisphaerica
HAMX	Tyto alba alba
HAMY	decomposition metagenome
HAMZ	Stichopus horrens
HANB	Ceratopteris richardii
HAND	Hordeum vulgare subsp. vulgare
HANF	Dicranum scoparium
HANH	Larus canus
HANI	Aplysina aerophoba
HANJ	Dysidea avara
HAOE	Vitis vinifera subsp. sylvestris
HBDL	Bathymodiolus azoricus
HBDN	Acidithiobacillus sp. co-culture
HBDO	Pinus nigra subsp. salzmannii
HBDQ	Mytilus edulis
HBDR	Nyctereutes procyonoides
HBDT	Argulus foliaceus
HBDU	Thoracosphaera heimii
HBDV	Polyblepharides amylifera
HBDW	Pycnococcus provasolii
HBDX	Ostreococcus sp. 'lucimarinus'
HBDY	Micromonas pusilla
HBDZ	Prasinoderma coloniale
HBEA	Pinguiococcus pyrenoidosus
HBEB	Diacronema lutheri
HBEC	Chlamydomonas euryale
HBED	Pseudictyota dubia
HBEE	Ostreococcus mediterraneus
HBEF	Craspedostauros australis
HBEG	Pyrodinium bahamense
HBEH	Pseudo-nitzschia arenysensis
HBEI	Rhizosolenia setigera
HBEJ	Minutocellus polymorphus
HBEK	Rhodosorus marinus
HBEL	Proboscia inermis
HBEM	Amorphochlora amoebiformis
HBEN	Micromonas pusilla
HBEO	Hanusia phi
HBEP	Phaeocystis antarctica
HBEQ	Micromonas pusilla
HBER	Calcidiscus leptoporus
HBES	Minchinia chitonis
HBET	Cafeteria roenbergensis
HBEU	Leptocylindrus aporus
HBEV	Micromonas pusilla
HBEW	Ostreococcus mediterraneus
HBEX	Asterionellopsis glacialis
HBEY	Coccolithus braarudii
HBEZ	Cryptomonas curvata
HBFA	Pyramimonas obovata
HBFB	Chlamydomonas leiostraca
HBFC	Mantoniella antarctica
HBFD	Chromulina nebulosa
HBFE	Erythrolobus madagascarensis
HBFF	Ostreococcus mediterraneus
HBFG	Pseudo-nitzschia delicatissima
HBFH	Chrysocystis fragilis
HBFI	Elphidium margaritaceum
HBFJ	Skeletonema marinoi
HBFK	Hemiselmis andersenii
HBFL	Pseudo-nitzschia delicatissima
HBFM	Polytomella parva
HBFN	Hemiselmis tepida
HBFO	Ostreococcus mediterraneus
HBFP	Timspurckia oligopyrenoides
HBFQ	Noctiluca scintillans
HBFR	Corethron hystrix
HBFS	Bicosoecida sp. CB-2014
HBFT	Oxyrrhis marina
HBFU	Skeletonema marinoi
HBFV	Picochlorum oklahomense
HBFW	Cyclophora tenuis
HBFX	Hemiselmis andersenii
HBFY	Thalassionema nitzschioides
HBFZ	Phaeocystis cordata
HBGB	Vitrella brassicaformis
HBGC	Cyclotella meneghiniana
HBGD	Percolomonas cosmopolitus
HBGE	Alexandrium catenella
HBGF	Neobodo designis
HBGG	Tetraselmis chuii
HBGH	Compsopogon caeruleus
HBGI	Erythrolobus australicus
HBGJ	Phaeomonas parva
HBGK	Grammatophora oceanica
HBGL	Sexangularia sp. CB-2014
HBGM	Skeletonema marinoi
HBGN	Ditylum brightwellii
HBGO	Trieres chinensis
HBGP	Stereomyxa ramosa
HBGQ	Alexandrium andersonii
HBGR	Pycnococcus provasolii
HBGS	Dictyocha speculum
HBGT	Florenciella parvula
HBGU	Haptolina brevifila
HBGV	Helicotheca tamesis
HBGW	Brandtodinium nutricula
HBGX	Cyanoptyche gloeocystis
HBGY	Leptocylindrus danicus
HBGZ	Skeletonema marinoi
HBHA	Bigelowiella natans
HBHB	Lankesteria abbotti
HBHC	Norrisiella sphaerica
HBHD	Chlamydomonas chlamydogama
HBHE	Triparma pacifica
HBHF	Lessardia elongata
HBHG	Akashiwo sanguinea
HBHH	Ostreococcus mediterraneus
HBHI	Eucampia antarctica
HBHJ	Rhizochromulina marina
HBHN	Prorocentrum micans
HBHP	Lotharella oceanica
HBHQ	Attheya septentrionalis
HBHR	Fibrocapsa japonica
HBHT	Amphiprora paludosa
HBHW	Rhodosorus marinus
HBHX	Haptolina ericina
HBHY	Prasinoderma singulare
HBIB	Palpitomonas bilix
HBIC	Spumella elongata
HBIJ	Aureoumbra lagunensis
HBIM	Amphora coffeiformis
HBIN	Aplanochytrium stocchinoi
HBIO	Chaetoceros debilis
HBIP	Dunaliella tertiolecta
HBIR	Emiliania huxleyi
HBIS	Picocystis salinarum
HBIT	Oxyrrhis marina
HBIU	Heterosigma akashiwo
HBIV	Lotharella globosa
HBIW	Pelagomonas calceolata
HBIX	Pseudo-nitzschia australis
HBIY	Schizochytrium aggregatum
HBIZ	Chrysotila carterae
HBJB	Oxyrrhis marina
HBJC	Prymnesium parvum
HBJD	Rhodella violacea
HBJE	Skeletonema marinoi
HBJF	Debaryomyces hansenii
HBJG	Conticribra weissflogii
HBJH	Thalassiosira rotula
HBJI	Schmidingerella taraikaensis
HBJJ	Heterosigma akashiwo
HBJK	Euplotes focardii
HBJL	Prorocentrum minimum
HBJN	Schizochytrium aggregatum
HBJO	Pseudo-nitzschia pungens
HBJP	Tetraselmis astigmatica
HBJQ	Bigelowiella natans
HBJS	Detonula confervacea
HBJT	Pseudo-nitzschia pungens
HBJU	Dinophysis acuminata
HBJV	Ditylum brightwellii
HBJW	Paraphysomonas vestita
HBJX	Paraphysomonas bandaiensis
HBJY	Minutocellus polymorphus
HBJZ	Coscinodiscus wailesii
HBKB	Triparma pacifica
HBKC	Thalassiosira punctigera
HBKE	Skeletonema costatum
HBKF	Rhodomonas abbreviata
HBKG	Bigelowiella natans
HBKH	Phaeocystis antarctica
HBKI	Lotharella globosa
HBKJ	Dolichomastix tenuilepis
HBKK	Chlorarachnion reptans
HBKL	Cylindrotheca closterium
HBKM	Protoceratium reticulatum
HBKN	Guillardia theta
HBKO	Prymnesium polylepis
HBKP	Vannella sp. CB-2014
HBKQ	Odontella aurita
HBKR	Paramoeba aestuarina
HBKS	Cryptomonas paramecium
HBKT	Chrysochromulina rotalis
HBKU	Litonotus pictus
HBKW	Porphyridium aerugineum
HBKY	Togula jolla
HBKZ	Chromera velia
HBLA	Filamoeba nolandi
HBLB	Astrosyne radiata
HBLC	Polarella glacialis
HBLD	Tetraselmis sp. GSL018
HBLE	Percolomonas cosmopolitus
HBLF	Stygamoeba regulata
HBLG	Skeletonema grethae
HBLH	Alexandrium minutum
HBLI	Dactyliosolen fragilissimus
HBLJ	Skeletonema japonicum
HBLK	Heterocapsa triquetra
HBLL	Thalassionema frauenfeldii
HBLN	Stephanopyxis turris
HBLO	Heterocapsa rotundata
HBLP	Bathycoccus prasinos
HBLQ	Ostreococcus mediterraneus
HBLR	Amphidinium massartii
HBLS	Prasinococcus capsulatus
HBLT	Gambierdiscus australes
HBLU	Crustomastix stigmatica
HBLV	Hemiselmis andersenii
HBLW	Gymnodinium catenatum
HBLX	Striatella unipunctata
HBLY	Micromonas polaris
HBLZ	Proteomonas sulcata
HBMA	Pelagomonas calceolata
HBMB	Hemiselmis andersenii
HBMD	Partenskyella glossopodia
HBME	Synedropsis cf. recta
HBMF	Minutocellus polymorphus
HBMG	Asterionellopsis glacialis
HBMI	Scyphosphaera apsteinii
HBMJ	Chrysoculter rhomboideus
HBMK	Bigelowiella longifila
HBML	Bigelowiella natans
HBMM	Pseudo-nitzschia heimii
HBMN	Chaetoceros cf. neogracilis
HBMO	Leptocylindrus danicus
HBMP	Stauroneis constricta
HBMQ	Chaetoceros brevis
HBMR	Bathycoccus prasinos
HBMS	Hemiselmis rufescens
HBMT	Licmophora paradoxa
HBMU	Synchroma pusillum
HBMV	Hemiselmis virescens
HBMY	Bathycoccus prasinos
HBMZ	Pycnococcus provasolii
HBNA	Chaetoceros dichaeta
HBNB	Exanthemachrysis gayraliae
HBNC	Skeletonema marinoi
HBND	Pavlova gyrans
HBNE	Madagascaria erythrocladioides
HBNF	Pelagodinium beii
HBNG	Gonyaulax spinifera
HBNH	Asterionellopsis glacialis
HBNI	Florenciella parvula
HBNJ	Heterocapsa arctica
HBNL	Alexandrium fundyense
HBNM	Chaetoceros affinis
HBNN	Polarella glacialis
HBNO	Amphidinium carterae
HBNP	Aureococcus anophagefferens
HBNQ	Ditylum brightwellii
HBNR	Alexandrium monilatum
HBNS	Ditylum brightwellii
HBNU	Emiliania huxleyi
HBNV	Ditylum brightwellii
HBNW	Chattonella subsalsa
HBNY	Chaetoceros neogracilis
HBNZ	Extubocellulus spinifer
HBOA	Crypthecodinium cohnii
HBOB	Emiliania huxleyi
HBOC	Emiliania huxleyi
HBOD	Corethron pennatum
HBOF	Heterosigma akashiwo
HBOG	Prymnesium polylepis
HBOH	Heterosigma akashiwo
HBOI	Fragilariopsis kerguelensis
HBOJ	Gloeochaete wittrockiana
HBOK	Tryblionella compressa
HBOL	Heterosigma akashiwo
HBOM	Isochrysis galbana
HBON	Gephyrocapsa oceanica
HBOO	Paraphysomonas imperforata
HBOQ	Perkinsus chesapeaki
HBOR	Pelagococcus subviridis
HBOZ	Conticribra weissflogii
HBPA	Pyramimonas parkeae
HBPB	Skeletonema menzelii
HBPD	Thalassionema nitzschioides
HBPE	Rhodomonas sp. CCMP768
HBPF	Pseudo-nitzschia fraudulenta
HBPG	Symbiodinium kawagutii
HBPH	Thalassiosira gravida
HBPI	Thalassiosira oceanica
HBPJ	Thalassiosira minuscula
HBPK	Vaucheria litorea
HBPL	Thalassiosira antarctica
HBPM	Scrippsiella hangoei
HBPN	Thalassiothrix antarctica
HBPO	Thalassiosira rotula
HBPR	Aureococcus anophagefferens
HBPW	Emiliania huxleyi
HBPX	Chloroparvula cf. pacifica RCC999
HBQA	Chloropicon maureeniae
HBQB	Diaphanoeca grandis
HBQC	Bigelowiella natans
HBQD	Chloroparvula sp. RCC696
HBQH	Ochromonas distigma AC25
HBQK	Pelagomonas calceolata
HBQL	Pelagomonas calceolata
IAAA	Parasteatoda tepidariorum
IAAB	Dugesia japonica
IAAC	Protobothrops mucrosquamatus
IAAD	Pogonomyrmex californicus
IAAE	Eleocharis vivipara
IAAF	Turritopsis sp. SK-2016
IAAG	Ambrosiozyma kashinagicola
IAAH	Yarrowia sp. JCM 30694
IAAI	Yarrowia sp. JCM 30695
IAAJ	Ogataea methanolica
IAAK	Triticum aestivum
IAAL	Triticum aestivum
IAAM	Triticum aestivum
IAAN	Aegilops tauschii
IAAO	Aegilops tauschii
IAAP	Aegilops tauschii
IAAQ	Aegilops tauschii
IAAR	Aegilops tauschii
IAAS	Aegilops tauschii
IAAT	Aegilops tauschii
IAAU	Aegilops tauschii
IAAV	Aegilops tauschii
IAAW	Aegilops tauschii
IAAX	Toxicodendron vernicifluum
IAAY	Hordeum vulgare
IAAZ	Hordeum vulgare
IABA	Oncorhynchus masou masou
IABB	Echinococcus multilocularis
IABC	Echinococcus multilocularis
IABD	Echinococcus multilocularis
IABE	Echinococcus multilocularis
IABF	Echinococcus multilocularis
IABG	Alkekengi officinarum var. franchetii
IABH	Physalis peruviana
IABI	Agarum clathratum
IABJ	Alaria crassifolia
IABK	Aureophycus aleuticus
IABL	Costaria costata
IABM	Pseudochorda nagaii
IABN	Saccharina angustata
IABO	Undaria pinnatifida
IABP	Heliopora coerulea
IABQ	Trypoxylus dichotomus tunobosonis
IABR	Plakobranchus ocellatus
IABS	Crematogaster osakensis
IABT	Protophormia terraenovae
IABU	Cryptomeria japonica
IABV	Cryptomeria japonica
IABW	Chrysanthemum x morifolium
IABX	Caridina multidentata
IABY	Parasteatoda tepidariorum
IABZ	Ligia exotica
IACA	Parasteatoda tepidariorum
IACB	Ipomoea batatas
IACC	Apteronemobius asahinai
IACD	Garcinia mangostana
IACE	Diacamma sp. Okinawa-2006a
IACF	Hirondellea gigas
IACG	Cricetulus griseus
IACH	Seriola quinqueradiata
IACI	Micrurus lemniscatus carvalhoi
IACJ	Micrurus corallinus
IACK	Micrurus lemniscatus lemniscatus
IACM	Micrurus spixii
IACN	Micrurus surinamensis
IACO	Seriola dumerili
IACP	Ficus carica
IACR	Rhinogobius flumineus
IACS	Grandidierella japonica
IACT	Hirondellea gigas
IACU	Hemicentrotus pulcherrimus
IACV	Nilaparvata lugens
IACW	Sarcoptes scabiei
IACY	Acanthamoeba sp. KDN1
IACZ	Vannella sp. KDN1
IADA	Naegleria sp. KDN1
IADB	Pleurotus salmoneostramineus
IADC	Dinophysis fortii
IADD	Cryptomeria japonica
IADE	Dianemobius nigrofasciatus
IADF	uncultured prokaryote
IADG	Euhadra quaesita
IADH	Adoxophyes honmai
IADJ	Trypoxylus dichotomus
IADK	Pinus thunbergii
IADL	Acropora tenuis
IADM	uncultured clade C Symbiodinium sp.
IADN	uncultured clade D Symbiodinium sp.
IADP	Baccaurea motleyana
IADQ	Nephelium lappaceum
IADR	Riptortus pedestris
IADS	Thrips tabaci
IADT	Spinacia oleracea
IADU	Aeginetia indica
IADV	Melampyrum roseum
IADW	Orobanche minor
IADX	Phtheirospermum japonicum
IADY	Pedicularis keiskei
IADZ	Aurelia sp. SETO
IAEA	Nipponaphis monzeni
IAEB	Nasutitermes takasagoensis
IALW	Octonoba okinawensis
IAQA	Octonoba yesoensis
IAST	Octonoba varians
IAUX	Octonoba sybotides
ICDQ	Octonoba grandiconcava
ICKD	Octonoba grandiprojecta
ICLB	Acropora tenuis
ICLD	Pyxicephalus adspersus
ICLE	Heterocypris incongruens
ICLF	Ulva prolifera
ICLG	Zophobas atratus
ICLH	Pristomyrmex punctatus
ICPE	Marchantia polymorpha subsp. ruderalis
ICPF	Marchantia polymorpha subsp. ruderalis
ICPG	Pinctada radiata
ICPK	Bombyx mori
ICPL	Striga hermonthica
ICPM	Eumeta japonica
ICPN	Pyxicephalus adspersus
ICPO	Triatoma rubrofasciata
ICPP	Gallirallus okinawae
ICPQ	Atrina pectinata
ICPR	Chroomonas sp. Dc01
ICPT	Sardinops melanostictus
ICPW	Chloromonas krienitzii
ICQR	Cryptomeria japonica
ICQS	Fimbriaphyllia ancora
ICQT	Cryptomeria japonica
ICQU	Mesostigma viride
ICRB	Polygala tenuifolia
ICRC	Scoparia dulcis
ICRE	Sphagnum palustre
ICRJ	Penaeus japonicus
ICRK	Penaeus japonicus
GBIL	Glossoscolex paulistus
GBIM	Scolopendra dehaani
GBIN	Acanthis hornemanni
GBIO	Avicennia marina
GBIP	Arachis duranensis
GBIQ	Arachis ipaensis
GBIR	Arachis duranensis
GBIS	Arachis ipaensis
GBIT	Bactrocera minax
GBIU	Arachis duranensis
GBIV	Arachis duranensis
GBIW	Arachis ipaensis
GBIX	Arachis hypogaea var. vulgaris
GBIY	Arachis hypogaea var. vulgaris
GBIZ	Arachis hypogaea var. vulgaris
GBJA	Opisthorchis felineus
GBJB	Andrographis paniculata
GBJC	Periplaneta americana
GBJD	Saccostrea glomerata
GBJE	Arachis hypogaea var. vulgaris
GBJF	Arachis duranensis
GBJG	Arachis ipaensis
GBJH	Arachis hypogaea var. vulgaris
GBJI	Arachis hypogaea var. vulgaris
GBJK	Arachis duranensis
GBJL	Arachis ipaensis
GBJM	Latrodectus geometricus
GBJN	Latrodectus hesperus
GBJO	Mangifera indica
GBJP	Arachis ipaensis
GBJQ	Steatoda grossa
GBJR	Bombyx mori
GBJS	Rhipicephalus annulatus
GBJT	Rhipicephalus annulatus
GBJU	Cycas revoluta
GBJV	Fusarium virguliforme
GBJW	Dioscorea composita
GBJX	Adelges tsugae
GBJY	Sinopodophyllum hexandrum
GBJZ	Allium cepa
GBKA	Ctenopharyngodon idella
GBKB	Staphylococcus aureus
GBKC	Crotalus horridus
GBKD	Crotalus horridus
GBKE	Lithobius forficatus
GBKF	Polyxenus lagurus
GBKG	Polydesmus angustus
GBKH	Triticum aestivum
GBKI	Triticum aestivum
GBKJ	Triticum aestivum
GBKK	Triticum aestivum
GBKL	Myxobolus cerebralis
GBKM	Acantholyda hieroglyphica
GBKN	Chrysis cortii
GBKO	Chrysis grohmanni
GBKP	Anthurium andraeanum
GBKQ	Camellia sinensis var. sinensis
GBKR	Apteronotus leptorhynchus
GBKS	Lilium hybrid cultivar
GBKT	Ephedra trifurca
GBKU	Trichoplusia ni
GBKV	Ciona intestinalis
GBKW	Olea europaea
GBKX	Eleusine indica
GBKY	Hedychrum nobile
GBKZ	Sphecodes albilabris
GBLA	Nomada lathburiana
GBLB	Astata minor
GBLD	Spintharina versicolor
GBLE	Brachymeria minuta
GBLF	Andrena vaga
GBLI	Spinolia lamprosoma
GBLJ	Pinus canariensis
GBLK	Mesembryanthemum crystallinum
GBLL	Dendrocerus carpenteri
GBLM	Cosmocomoidea triguttata
GBLN	Cosmocomoidea morrilli
GBLO	Cosmocomoidea morgani
GBLP	Diglyphus isaea
GBLQ	Chrysis terminata
GBLR	Thyreus orbatus
GBLS	Dinetus pictus
GBLT	Perilampus aeneus
GBLU	Oxybelus bipunctatus
GBLV	Chyphotes sp. AD-2014
GBLW	Trichrysis cyanea
GBLX	Tremex magus
GBLY	Eucera plumigera
GBLZ	Eucera syriaca
GBMA	Diodontus minutus
GBMB	Pseudochrysis neglecta
GBMC	Trichogramma evanescens
GBMD	Ancistrocerus nigricornis
GBME	Panurgus dentipes
GBMF	Discoelius zonalis
GBMG	Eumenes papillarius
GBMH	Holopyga generosa
GBMI	Podagrion pachymerum
GBMJ	Lithurgus chrysurus
GBMK	Chrysis fasciata
GBML	Symmorphus murarius
GBMM	Tamarixia radiata
GBMN	Eupelmus urozonus
GBMO	Celonites abbreviatus
GBMP	Dasypoda hirtipes
GBMQ	Hedychridium ardens
GBMR	Delta sp. AD-2014
GBMS	Brachygaster minutus
GBMT	Ammophila sabulosa
GBMU	Stephanus serrator
GBMV	Pseudomalus pusillus
GBMW	Parischnogaster nigricans
GBMX	Ammobates syriacus
GBMY	Netelia sp. AD-2014
GBMZ	Chlorodynerus chloroticus
GBNA	Otitesella tsamvi
GBNB	Stizus continuus
GBNC	Telenomus sp. AD-2014
GBND	Buathra laborator
GBNE	Leptomastix dactylopii
GBNF	Harpactus elegans
GBNG	Vespula germanica
GBNH	Psenulus fuscipennis
GBNI	Eucera malvae
GBNJ	Pseudogonalos hahnii
GBNK	Chrysis analis
GBNL	Sceliphron curvatum
GBNM	Chrysis mixta
GBNN	Nysson niger
GBNO	Dolichurus corniculus
GBNP	Euglossa dilemma
GBNQ	Smicromyrme rufipes
GBNR	Gorytes laticinctus
GBNS	Cerceris arenaria
GBNT	Ampulex compressa
GBNU	Euodynerus quadrifasciatus
GBNV	Chrysura dichroa
GBNW	Pseudoscolia sinaitica
GBNX	Macropis fulvipes
GBNY	Andricus quercuscalicis
GBNZ	Heterodontonyx sp. AD-2014
GBOA	Spilomena beata
GBOB	Sphecius convallis
GBOC	Palarus histrio
GBOD	Chrysis mochii
GBOE	Chlorion hirtum
GBOF	Chrysis scutellaris
GBOG	Sirex noctilio
GBOH	Masaris aegyptiacus aegyptiacus
GBOI	Camptopoeum sacrum
GBOJ	Anthidium manicatum
GBOK	Meria tripunctata
GBOL	Cimbex rubida
GBOM	Chalybion californicum
GBON	Dryudella pinguis
GBOP	Chrysura ciscirtana
GBOQ	Dasymutilla gloriosa
GBOR	Syrphophilus tricinctorius
GBOS	Dendrocerus carpenteri
GBOT	Rhynchium cyanopterum
GBOU	Liris sp. AD-2014
GBOV	Philotrypesis parca
GBOW	Chrysis gracillima
GBOX	Quartinia thebaica
GBOY	Mellinus arvensis
GBOZ	Chrysis propinquata
GBPA	Bootanomyia dorsalis
GBPB	Lachaisea equicollis
GBPC	Prospinolia theresae
GBPD	Sycophila biguttata
GBPE	Hyposoter didymator
GBPF	Theocolax elegans
GBPG	Eucera nigrescens
GBPH	Arge berberidis
GBPI	Urocerus augur
GBPJ	Heteropelma amictum
GBPK	Stilbum cyanurum
GBPL	Chrysis splendidula
GBPM	Pimpla flavicoxis
GBPN	Chelostoma florisomne
GBPO	Pison atrum
GBPP	Dioxys cincta
GBPQ	Sapygina decemguttata
GBPR	Tachysphex fulvitarsis
GBPS	Hylaeus variegatus
GBPT	Lasioglossum xanthopus
GBPU	Ceratina chalybea
GBPV	Auplopus albifrons
GBPW	Epeolus variegatus
GBPX	Podalonia hirsuta
GBPY	Isodontia mexicana
GBPZ	Coelioxys conoidea
GBQA	Torymus bedeguaris
GBQB	Euura ribesii
GBQC	Eurytoma brunniventris
GBQD	Sphex funerarius
GBQE	Cephalonomia tarsalis
GBQF	Bombus rupestris
GBQG	Megalodontes cephalotes
GBQH	Pemphredon lugens
GBQI	Prionyx kirbii
GBQJ	Scolia hirta
GBQK	Heriades truncorum
GBQL	Episyron rufipes
GBQM	Colpa sexmaculata
GBQN	Megachile willughbiella
GBQO	Stizoides tridentatus
GBQP	Halictus quadricinctus
GBQQ	Katamenes arbustorum
GBQR	Bembix rostrata
GBQS	Vespa crabro
GBQT	Chrysis graelsii sybarita
GBQU	Nitela sp. AD-2014
GBQV	Eucera sp. 'Tetraloniella' AD-2014
GBQW	Hedychridium coriaceum
GBQX	Pinus monticola
GBQY	Unedogemmula bisaya
GBQZ	Crassispira cerithina
GBRA	Gemmula speciosa
GBRB	Salmo salar
GBRC	Camellia sinensis
GBRD	Lygus hesperus
GBRE	Irpex lacteus
GBRF	Hirudo medicinalis
GBRG	Aurelia aurita
GBRH	Arundo donax
GBRI	Litchi chinensis
GBRJ	Oryza officinalis
GBRK	Limonium bicolor
GBRL	Sitodiplosis mosellana
GBRM	Elysia timida
GBRN	Allium cepa
GBRO	Allium cepa
GBRP	Lupinus angustifolius
GBRQ	Allium cepa
GBRR	Symbiodinium sp. clade D
GBRS	Calluna vulgaris
GBRT	Petunia exserta
GBRU	Petunia axillaris
GBRV	Petunia integrifolia
GBRW	Elysia cornigera
GBRX	Glossina palpalis gambiensis
GBRY	Primula vulgaris
GBRZ	Symbiodinium sp. B2
GBSA	Chaetoceros affinis
GBSB	Diabrotica virgifera virgifera
GBSC	Cladocopium sp. clade C
GBSD	Corchorus capsularis
GBSE	Corchorus capsularis
GBSF	uncultured Microsporidia
GBSG	Cronartium ribicola
GBSH	Boiga irregularis
GBSI	Hypsiglena sp. JMG-2014
GBSJ	Diospyros lotus
GBSK	Mesostigma viride
GBSL	Coleochaete orbicularis
GBSM	Spirogyra pratensis
GBSN	Lathyrus sativus
GBSO	Klebsormidium flaccidum
GBSP	Penicillium janthinellum
GBSQ	Penicillium janthinellum
GBSR	Ixodes scapularis
GBSS	Lathyrus sativus
GBST	Nitella mirabilis
GBSU	Aphis glycines
GBSV	Elaeis guineensis
GBSW	Calluna vulgaris
GBSX	Achromobacter sp. HZ01
GBSY	Andrographis paniculata
GBSZ	Tigriopus californicus
GBTA	Helicoverpa assulta
GBTC	Tigriopus californicus
GBTD	Oncorhynchus mykiss
GBTE	Anopheles quadrimaculatus
GBTF	Dacnusa sibirica
GBTG	Alastor atropos
GBTH	Courtella sp. AD-2014
GBTI	Leptochilus alpestris
GBTK	Aphelinus abdominalis
GBTL	Tetragonula carbonaria
GBTM	Anthophora plumipes
GBTN	Gymnomerus laevipes
GBTO	Plectranthus barbatus
GBTP	Aproceros leucopoda
GBTQ	Lestica clypeata
GBTR	Tanaostigmodes howardii
GBTS	Orussus unicolor
GBTT	Chrysis inaequalis
GBTU	Orasema simulatrix
GBTV	Azolla filiculoides
GBTW	Elisabethiella stueckenbergi
GBTX	Praestochrysis megerlei
GBTY	Dufourea dentiventris
GBTZ	Methocha articulata
GBUA	Alysson spinosus
GBUB	Chrysis indigotea
GBUC	Omalus biaccinctus
GBUD	Oodera sp. AD-2014
GBUE	Brasema neomexicana
GBUF	Eriocheir sinensis
GBUG	Echis coloratus
GBUH	Chrysomela populi
GBUI	Phaedon cochleariae
GBUJ	Colletes cunicularius
GBUK	Osmia cornuta
GBUL	Chrysura austriaca
GBUM	Xylocopa violacea
GBUN	Cleptes nitidulus
GBUO	Diprion pini
GBUP	Trissolcus semistriatus
GBUQ	Trichopria drosophilae
GBUR	Chrysis germari
GBUS	Cephaloparnops vareillesi
GBUT	Chrysis ehrenbergi
GBUU	Ormyrus sp. AD-2014
GBUV	Chrysis pseudoincisa
GBUW	Chrysis zobeida
GBUX	Chrysis sp. AD-2014
GBUY	Aleiodes testaceus
GBUZ	Omalus aeneus
GBVA	Philoctetes bogdanovii
GBVB	Inostemma sp. AD-2014
GBVC	Metaphycus flavus
GBVD	Ceraphron sp. AD-2014
GBVE	Aphidius colemani
GBVF	Blasticotoma filiceti
GBVG	Gasteruption tournieri
GBVH	Xyela alpigena
GBVI	Cephus spinipes
GBVJ	Eucera nigriceps
GBVK	Melitta haemorrhoidalis
GBVL	Passaloecus eremita
GBVM	Ibalia leucospoides ensiger
GBVN	Encarsia formosa
GBVO	Ampulex fasciata
GBVP	Nomioides sp. AD-2014
GBVQ	Stenodynerus steckianus
GBVR	Lariophagus distinguendus
GBVS	Microdynerus nugdunensis
GBVT	Netelia testacea
GBVU	Pelecinus polyturator
GBVV	Spalangia cameroni
GBVW	Mangifera indica
GBVX	Mangifera indica
GBVY	Anopheles stephensi
GBVZ	Chrysis cerastes
GBWA	Synergus umbraculus
GBWB	Philocaenus barbarus
GBWC	Ichneumon albiger
GBWD	Macrocentrus marginator
GBWE	Pompilus cinereus
GBWF	Systropha curvicornis
GBWG	Crabro peltarius
GBWH	Crossocerus quadrimaculatus
GBWI	Philanthus triangulum
GBWJ	Xiphydria camelus
GBWK	Leucospis dorsigera
GBWL	Pachycrepoideus vindemmiae
GBWM	Diaeretus essigellae
GBWN	Tiphia femorata
GBWO	Trypoxylon figulus
GBWP	Pseudapis diversipes
GBWQ	Monosapyga clavicornis
GBWR	Polistes dominula
GBWS	Aulacus burquei
GBWT	Odynerus spinipes
GBWU	Pediaspis aceris
GBWV	Stelis punctulatissima
GBWW	Pseudochrysis schmiedeknechti
GBWX	Elampus spina
GBWY	Sapyga quinquepunctata
GBWZ	Pergagrapta polita
GBXA	Parnopes grandior
GBXB	Banksia hookeriana
GBXC	Limacina retroversa
GBXD	Helicoverpa armigera
GBXE	Carcinus maenas
GBXF	Pyrodinium bahamense var. compressum
GBXG	Hypericum perforatum
GBXH	Cadra cautella
GBXI	Zeugodacus cucurbitae
GBXJ	Anthopleura elegantissima
GBXK	Bathymodiolus platifrons
GBXL	Pyrus communis
GBXM	Anguilla anguilla
GBXN	Amphimedon queenslandica
GBXO	Vigna radiata
GBXP	Vitis vinifera
GBXQ	Ixodes persulcatus
GBXR	Tityus bahiensis
GBXS	Trematomus bernacchii
GBXT	Calanus glacialis
GBXU	Calanus finmarchicus
GBXV	Brachionus koreanus
GBXW	Lolium temulentum
GBXX	Lolium multiflorum
GBXY	Lolium multiflorum
GBXZ	Festuca pratensis
GBYA	Jatropha curcas
GBYB	Fopius arisanus
GBYC	Anthopleura elegantissima
GBYD	Euwallacea fornicatus
GBYE	Acacia koa
GBYF	Gigaspora margarita
GBYG	Numida meleagris
GBYH	Cimex lectularius
GBYI	Prymnesium parvum
GBYJ	Prymnesium parvum
GBYK	Gossypium arboreum
GBYL	Neophocaena asiaeorientalis
GBYM	Coriolopsis gallica
GBYN	Lolium arundinaceum
GBYO	Setaria italica
GBYP	Neophocaena asiaeorientalis
GBYQ	Porichthys notatus
GBYR	Ginkgo biloba
GBYS	Oryza meyeriana
GBYT	Biomphalaria glabrata
GBYU	Biomphalaria glabrata
GBYV	Biomphalaria glabrata
GBYW	Pacifastacus leniusculus
GBYX	Poeciliopsis prolifica
GBYY	Thaumetopoea pityocampa
GBYZ	Thaumetopoea pityocampa
GBZA	Sus scrofa domesticus
GBZB	Thaumetopoea pityocampa
GBZC	Antheraea assamensis
GBZD	Samia ricini
GBZE	Rhodinia newara
GBZF	Antheraea pernyi
GBZG	Alternaria alternata
GBZH	Ipomoea batatas
GBZI	Cucurbita pepo
GBZJ	Antheraea yamamai
GBZK	Calotropis procera
GBZL	Actias selene
GBZM	Carassius auratus
GBZN	Schmidtea polychroa
GBZO	Morus alba var. alba
GBZP	Triticum aestivum
GBZQ	Zea nicaraguensis
GBZR	Hypsibius dujardini
GBZS	Spodoptera litura
GBZT	Platynereis dumerilii
GBZU	Tityus serrulatus
GBZV	Lateolabrax maculatus
GBZW	Eriocheir sinensis
GBZX	Amblyomma americanum
GBZY	Viola uliginosa
GBZZ	Pomacea canaliculata
GCAA	Zea nicaraguensis
GCAB	Viola uliginosa
GCAC	Panonychus ulmi
GCAD	Litchi chinensis
GCAH	Clinopodes flavidus
GCAP	Scolopendra cingulata
GCAQ	Scutigera coleoptrata
GCAR	Euscorpius sicanus
GCAT	Triops cancriformis
GCAY	Lithobius forficatus
GCBC	Xibalbanus tulumensis
GCBI	Anaspides tasmaniae
GCBP	Eubranchipus grubii
GCBQ	Morpheis pyracmon
GCCL	Ecdyonurus insignis
GCCU	Demonarosa rufotessellata
GCDB	Nebalia bipes
GCDE	Mycastor nealces
GCDF	Tineola bisselliella
GCDG	Amphipyra pyramidea
GCDH	Saturnia pyri
GCDI	Colias croceus
GCDJ	Catoptria falsella
GCDK	Hyles euphorbiae
GCDM	Mortonagrion selenion
GCDV	Coptotriche citrinipennella
GCDW	Ganisa similis
GCDX	Psyttalia concolor
GCEL	Cipangopaludina cathayensis
GCEP	Bienertia sinuspersici
GCEQ	Psyttalia lounsburyi
GCER	Archegozetes longisetosus
GCES	Fundulus heteroclitus
GCET	Coptotermes gestroi
GCEW	Sapromyza sciomyzina
GCFC	Eustalomyia vittipes
GCFE	Scatella tenuicosta
GCFF	Calliphora vomitoria
GCFG	Baccha elongata
GCFH	Archimicrodon brachycerus
GCFJ	Limnia unguicornis
GCFM	Episyrphus balteatus
GCFN	Mesembrina meridiana
GCFT	Lenophila dentipes
GCFU	Melanagromyza sp. AD-2014
GCFV	Piophila australis
GCGA	Lispe sydneyensis
GCGE	Nephrocerus atrapilus
GCGG	Myopa sp. AD-2014
GCGH	Fergusonina omlandi
GCGJ	Locusta migratoria manilensis
GCGL	Eristalis pertinax
GCGM	Penicillidia dufourii
GCGO	Heteropsilopus ingenuus
GCGQ	Tapeigaster digitata
GCGS	Derocephalus angusticollis
GCGT	Melanostoma scalare
GCGU	Platypeza anthrax
GCGW	Ortholfersia macleayi
GCGX	Platycodon grandiflorus
GCGY	Platycodon grandiflorus
GCGZ	Platycodon grandiflorus
GCHA	Tigriopus japonicus
GCHC	Hanseniella sp. AD-2014
GCHE	Capra hircus
GCHF	Abrothrix longipilis hirtus
GCHG	Abrothrix longipilis hirtus
GCHH	Abrothrix longipilis hirtus
GCHI	Abrothrix longipilis hirtus
GCHK	Abrothrix longipilis hirtus
GCHL	Abrothrix longipilis hirtus
GCHM	Abrothrix longipilis hirtus
GCHN	Abrothrix longipilis hirtus
GCHQ	Ferdinandea cuprea
GCHT	Solanum commersonii
GCHU	Wollemia nobilis
GCHV	Podocoryna carnea
GCHW	Hydractinia symbiolongicarpus
GCHX	Picea glauca
GCIB	Colobanthus quitensis
GCIC	Abrothrix longipilis hirtus
GCID	Nymphon gracile
GCIH	Symphylella sp. AD-2014
GCIL	Himantarium gabrielis
GCIR	Abrothrix longipilis hirtus
GCIS	Abrothrix longipilis hirtus
GCIT	Tisbe furcata
GCIU	Eudigraphis takakuwai
GCIV	Thalassisobates littoralis
GCIW	Hemidiaptomus amblyodon
GCIX	Ommatoiulus sabulosus
GCIY	Scolopocryptops rubiginosus
GCJD	Abrothrix longipilis hirtus
GCJE	Abrothrix longipilis hirtus
GCJH	Abrothrix longipilis hirtus
GCJI	Abrothrix longipilis hirtus
GCJJ	Ornithodoros rostratus
GCJK	Abrothrix longipilis hirtus
GCJL	Kosteletzkya pentacarpos
GCJM	Conus tribblei
GCJN	Oikopleura dioica
GCJO	Ixodes ricinus
GCJP	Biston suppressaria
GCJS	Phragmatobia fuliginosa
GCJT	Paracyclopina nana
GCJU	Zymoseptoria tritici
GCJV	Olea europaea
GCJW	Secale cereale
GCJX	Zymoseptoria ardabiliae
GCJY	Zymoseptoria pseudotritici
GCJZ	Persicaria minor
GCKA	Pisum sativum subsp. sativum
GCKB	Aethina tumida
GCKC	Gleditsia sinensis
GCKD	Elaeis guineensis
GCKE	Pardosa pseudoannulata
GCKF	Araucaria cunninghamii
GCLM	Aedes albopictus
GCLW	Coelopa frigida
GCLX	Cuterebra austeni
GCMA	Euthera bicolor
GCMC	Hilarini sp. AD-2014
GCME	Leucozona lucorum
GCMF	Pisum sativum
GCMG	Pisum sativum
GCMH	Pisum sativum
GCMI	Pisum sativum
GCMJ	Pisum sativum
GCMK	Pisum sativum
GCML	Pisum sativum
GCMM	Pisum sativum subsp. sativum
GCMN	Pisum sativum subsp. sativum
GCMO	Pisum sativum subsp. sativum
GCMP	Pisum sativum subsp. sativum
GCMQ	Pisum sativum subsp. sativum
GCMR	Lonchoptera bifurcata
GCMS	Loxocera cylindrica
GCMU	Megaselia abdita
GCMV	Merodon equestris
GCMW	Pipiza noctiluca
GCMY	Pseudodinia antennalis
GCNB	Stomorhina subapicalis
GCND	Syritta pipiens
GCNH	Zacompsia fulva
GCNI	Meroplius fasciculatus
GCNJ	Micropeza corrigiolata
GCNK	Mumetopia occipitalis
GCNQ	Epinephelus fuscoguttatus
GCNR	Corchorus capsularis
GCNS	Corchorus capsularis
GCNT	Acanthogobius hasta
GCNU	Amata phegea
GCNV	Amphithera heteroleuca
GCNW	Andesiana lamellata
GCNX	Anthocharis cardamines
GCNY	Auriculoceryx pterodactyliformis
GCNZ	Autosticha sp. AD-2014
GCOA	Bembecia ichneumoniformis
GCOB	Bicyclus anynana
GCOC	Brahmaea hearseyi
GCOD	Cameraria ohridella
GCOE	Canaea sp. AD-2014
GCOF	Dendrolimus pini
GCOG	Harmaclona sp. AD-2014
GCOJ	Lyssa zampa
GCOK	Macrauzata submontana
GCOL	Macrosoma sp. AD-2014
GCOM	Menevia lantona
GCON	Mustilizans dierli
GCOO	Phyllodes eyndhovii
GCOP	Neopseustis meyricki
GCOQ	Nymphalis c-album
GCOS	Pterodecta felderi
GCOT	Pterophorus pentadactyla
GCOU	Mania lunus
GCOV	Pararge aegeria
GCOW	Sphinx pinastri
GCOX	Spilomela sp. AD-2018
GCOY	Thyatira batis
GCOZ	Cirrhochrista sp. AD-2014
GCPA	Pheosia gnoma
GCPB	Megastigmus spermotrophus
GCPC	Trosia sp. AD-2014
GCPD	Urbanus proteus
GCPE	Nippancistroger testaceus
GCPF	Cheddikulama straminea
GCPG	Diestrammena asynamora
GCPH	Tirachoidea westwoodii
GCPI	Gonolabis marginalis
GCPJ	Xya variegata
GCPK	Hymenopus coronatus
GCPL	Creobroter pictipennis
GCPM	Phyllium philippinicum
GCPN	Orthodera novaezealandiae
GCPO	Popa spurca
GCPP	Orthomeria sp. AD-2014
GCPQ	Acontista multicolor
GCPR	Schultesia lampyridiformis
GCPS	Lamproblatta albipalpus
GCPT	Megalomus tortricoides
GCPU	Distoleon tetragrammicus
GCPV	Chrysopa perla
GCPW	Turcoraphidia amara
GCPX	Phaeostigma divina
GCPY	Libelloides macaronius
GCPZ	Venustoraphidia nigricollis
GCQA	Drepanepteryx phalaenoides
GCQB	Hypochrysa elegans
GCQC	Sympherobius elegans
GCQD	Phaeostigma major
GCQE	Raphidia mediterranea
GCQF	Subilla confinis
GCQG	Sialis lutaria
GCQH	Nevrorthus apatelios
GCQI	Micromus variegatus
GCQJ	Ohmella baetica bolivari
GCQK	Coniopteryx sp. AD-2015
GCQL	Ophiocordyceps sinensis
GCQM	Semidalis aleyrodiformis
GCQN	Norfolius howensis
GCQO	Sympherobius pygmaeus
GCQP	Macronemurus sp. AD-2015
GCQW	Chrysopa phyllochroma
GCQX	Micromus lanosus
GCQY	Bucculatrix cristatella
GCQZ	Stigmella atricapitella
GCRB	Primeuchroeus cf. incisicollis AD-2015
GCRC	Chrysidea disclusa
GCRD	Chrysis cavifacies
GCRE	Coniopteryx pygmaea
GCRF	Wesmaelius concinnus
GCRG	Chrysura ciscirtana
GCRH	Plumarius gradifrons
GCRJ	Agulla sp. AD-2015
GCRK	Ascalaphidae sp. AD-2015
GCRM	Megistoleon ritsemae
GCRN	Eumantispa harmandi
GCRO	Hemerobius pini
GCRP	Sisyra terminalis
GCRQ	Protohermes xanthodes
GCRR	Pseudimares aphrodite
GCRS	Neuroleon sp. AD-2015
GCRV	insect metagenome
GCRW	Raphanus sativus
GCRX	Plantago ovata
GCRY	Pygsuia biforma
GCRZ	Camellia taliensis
GCSA	Plantago ovata
GCSB	Plantago ovata
GCSC	Plantago ovata
GCSD	Neohermes sp. AD-2015
GCSE	Chrysopa dorsalis
GCSF	Xanthostigma gobicola
GCSG	Dilar turcicus
GCSH	Dendroleon pantherinus
GCSI	Ornatoraphidia flavilabris
GCSJ	Puncha ratzeburgi
GCSK	Halter nutans
GCSL	Hemerobius marginatus
GCSM	Bubopsis andromache
GCSN	Fibla maclachlani
GCSO	Mantispa styriaca
GCSP	Corydalidae sp. AD-2015
GCSQ	Protohermes grandis
GCSR	Mantispinae sp. AD-2015
GCSS	Negha sp. AD-2015
GCST	Atlantoraphidia maculicollis
GCSU	Pseudomallada flavifrons flavifrons
GCSV	Dichrostigma flavipes
GCSW	Pseudomallada ventralis
GCSX	Podallea sp. AD-2015
GCSY	Hemerobius stigma
GCSZ	Cunctochrysa albolineata
GCTA	Wesmaelius ravus
GCTB	Hemerobius nitidulus
GCTC	Chrysotropia ciliata
GCTD	Chrysoperla carnea
GCTE	Peyerimhoffina gracilis
GCTF	Inocellia japonica
GCTG	Myrmeleon formicarius
GCTH	Hemerobius micans
GCTI	Sisyra nigra
GCTJ	Polystoechotes punctata
GCTK	Nemoptera sinuata
GCTL	Nineta pallida
GCTM	Spodoptera frugiperda
GCTN	Micromus paganus
GCTO	Hemerobius humulinus
GCTP	Lolium arundinaceum
GCTQ	Chrysopa pallens
GCTR	Hemerobius handschini
GCTS	Chrysopa formosa
GCTT	Mongoloraphidia sororcula
GCTU	Suarius sp. AD-2015
GCTV	Sialis fuliginosa
GCTW	Peyerimhoffina gracilis
GCTX	Nodalla sp. AD-2015
GCTY	Megalithone tillyardi
GCTZ	Distoleon annulatus
GCUD	Chauliodes sp. AD-2015
GCUE	Chrysis gribodoi
GCUG	Pseudochrysis neglecta
GCUI	Chrysis pseudoincisa
GCUJ	Euchroeus doursi
GCUK	Vargula hilgendorfii
GCUL	Chrysis ehrenbergi
GCUM	Hedychrum rutilans
GCUN	Eucharis adscendens
GCUR	Alucita desmodactyla
GCUS	Agrotis infusa
GCUT	Chrysis dives
GCUU	Elasmus sp. AD-2014
